99 Thuwanon Co Ltd	Thailand
Abaga Daan Mining Co Ltd	China
Aboitiz Equity Ventures Inc	Philippines
Aboitiz Power Corp	Philippines
Abovant Holdings Inc	Philippines
Abovant Holdings Inc	Philippines
ACB (India) Ltd	India
AC Energy and Infrastructure Corp	Philippines
ACNR Mining Corp Inc	USA
ACNR Resources Inc	USA
Adani Australia Co Pty Ltd	Australia
Adani Electricity Mumbai Ltd	India
Adani Enterprises Ltd	India
Adani Group	India
Adani Hazira Port Ltd	India
Adani Krishnapatnam Port Ltd	India
Adani Ports and Special Economic Zone Ltd	India
Adani Power Dahej Ltd	India
Adani Power (Jharkhand) Ltd 	India
Adani Power Ltd	India
Adani Power Maharashtra Ltd 	India
Adani Power (Mundra) Ltd	India
Adani Power Rajasthan Ltd 	India
Adani Rugby Run Finance Pty Ltd	Australia
Adani Transmission Ltd	India
Adhunik Power & Natural Resources Ltd	India
AEP Generating Co	USA
AEP Generation Resources Inc	USA
AES Andes SA	Chile
AES Argentina Generacion SA	Argentina
AES Bulgaria BV	Bulgaria
AES Indiana	USA
AES Mong Duong Finance Holdings BV	Netherlands
AES Mong Duong Power Co Ltd	Vietnam
AES Mong Duong Power Co Ltd	Vietnam
AES Ohio	USA
AEV International Pte Ltd	Singapore
Africa Coal Partners Ltd	South Africa
African Energy Ltd	Botswana
African Power Coal Ltd	Zambia
Agarwal Coal Corp Pvt Ltd	India
AGE Terminal Co Ltd	Thailand
AGE Transport Co Ltd	Thailand
AGL Energy Ltd	Australia
AGL Loy Yang Pty Ltd	Australia
AGL Macquarie Pty Ltd	Australia
Agritrade International Pte Ltd	Singapore
Agritrade Resources Ltd	Singapore
Air Products And Chemicals Inc	USA
Air Water & Energia Power Yamaguchi Corp	Japan
Air Water & Energia Power Yamaguchi Corp	Japan
Akcelik Madencilik Tic ve San AS	Turkey
Akemi Electric Power Ltd	Japan
Alabama Power Capital Trust III	USA
Alabama Power Capital Trust II	USA
Alabama Power Capital Trust I	USA
Alabama Power Capital Trust V	USA
Alabama Power Co	USA
Aletai Xintai Mining Co Ltd 	China
ALLETE Inc	USA
ALLETE (Minnesota Power)	USA
Alliance Coal LLC	USA
Alliance Holdings GP LP	USA
Alliance Resource Partners LP	USA
Alliant Energy Corp	USA
Alliant Energy Finance LLC	USA
Almaty Power Plants JSC 	Kazakhstan
Alsons Thermal Energy Corp 	Philippines
Alsons Thermal Energy Corp 	Philippines
Alsons Thermal Energy Corp 	Philippines
Alsons Thermal Energy Corp 	Philippines
Alton Coal Development LLC	USA
Altraso Ventures Ltd	Russia
Aluminum Corporation of China Ltd	China
Ameren Corp	USA
American Bituminous Power LP	USA
American Consolidated Natural Resources Inc	USA
American Electric Power Co Inc (AEP) 	USA
Anadolu Birlik Holding AS	Turkey
Andhra Pradesh Power Development Co Ltd 	India
Andhra Pradesh Power Generation Corp Ltd	India
Angul Energy Ltd	India
Anhui Hengyuan Coal Industry and Electricity Power Co Ltd	China
Anhui Huadian Lu'an Power Plant Co Ltd	China
Anhui Huadian Suzhou Power Generation Co Ltd	China
Anhui Huadian Wuhu Power Generation Co Ltd	China
Anhui Province Energy Group Co Ltd (Wenergy Group)	China
Anhui Wanbei Coal - Electricity Group Co Ltd	China
Anhui Wenergy Co Ltd	China
An Khanh - Bac Giang Thermoelectric JSC	Vietnam
An Khanh Electricity JSC	Vietnam
Anshan Heavy Duty Mining Machinery Co Ltd	China
Anyang Dazhong Coal Industry Co Ltd	China
Anyuan Coal Industry Group Co	China
Appalachian Power Co	USA
Apraava Energy Pvt Ltd	India
Aq Sora LLC	China (Hong Kong)
Aquila Capital LP	USA
Aravali Power Co Pvt Ltd	India
Aravali Power Co Pvt Ltd	India
Arch Coal Asia-Pacific Pte Ltd	Singapore
Arch Coal Sales Co Inc	USA
Arch Resources Inc	USA
Ares Asia Ltd	China (Hong Kong)
Arindo Holdings Mauritius Ltd	Mauritius
Arizona Public Service Co	USA
ARM Coal Pty Ltd	South Africa
Arnot InvestCo Pty Ltd	South Africa
ARS Energy Pvt Ltd	India
Aryan Clean Coal Technologies Pvt Ltd	India
Aryan Energy Pvt Ltd	India
Ashton Coal Operations Ltd (ACOL)	Australia
Ashton Coal Operations Ltd (ACOL)	Australia
Asia Energy (Bangladesh) Pvt Ltd	Bangladesh
Asia Green Energy PLC	Thailand
Assam Mineral Development Corp Ltd	India
Associated Electric Cooperative Inc	USA
ASTRA SEDAYA FINANCE PT	Indonesia
Athena Chhattisgarh Power Ltd	India
Athena Energy Ventures Pvt Ltd	India
Atimonan One Energy Inc 	Philippines
Atimonan One Energy Inc 	Philippines
Atimonan One Energy Inc 	Philippines
Atimonan One Energy Inc 	Philippines
Atlas Enerji Uretim AS	Turkey
Aurizon Finance Pty Ltd	Australia
Aurizon Holdings Ltd	Australia
Aurobindo Reality and Infrastructure Pvt Ltd	India
Auro Coal Pvt Ltd	India
Austar Coal Mine Pty Ltd	Australia
Austar Coal Mine Pty Ltd	Australia
AustChina Holdings Ltd	Australia
Australian Pacific Coal Ltd	Australia
Australian Rail Track Corp Ltd (ARTC)	Australia
Avani Resources Pte Ltd	Singapore
Avantha Power & Infrastructure Ltd	India
Aydem Holding AS	Turkey
Baganuur JSC	Mongolia
Baganuur Power LLC	Mongolia
Baicheng County Fengfeng Coal Coking Co Ltd	China
Baikal Energy Company LLC	Russia
Bajaj Energy Ltd	India
Bajaj Hindusthan (Singapore) Pvt Ltd 	India
Bajaj Hindusthan Sugar Ltd	India
Bajaj Power Ventures Pvt Ltd	India
Balingian Energy Minerals Sdn Bhd	Malaysia
Balingian Power Generation Sdn Bh	Malaysia
Balkhash TPP JSC	Kazakhstan
Bangladesh Barisal Power Co Ltd	Bangladesh
Bangladesh-China Power Co Pvt Ltd	Bangladesh
Bangladesh India Friendship Power Co Ltd	Bangladesh
Bangladesh India Friendship Power Co Ltd	Bangladesh
Bangladesh Power Development Board	Bangladesh
Banpu Investment (China) Ltd 	China
Banpu Power Public Co Ltd	Thailand
Banpu Public Co Ltd	Thailand
Banpu (Shanghai) Trading Co Ltd	China
Baode County Shendong Power Generation Co Ltd	China
Baotailong New Materials CO LTD	China
Barapukuria Coal Mining Co Ltd	Bangladesh
Barkun County Xinyuan Coal Co Ltd	China
Barmer Lignite Mining Co Ltd 	India
Basin Electric Power Cooperative	USA
Batchfire Resources Pty Ltd	Australia
Bazhou Dongchen Industry and Trade Co Ltd	China
Beifa Investments Pvt Ltd	Zimbabwe
Beifang Yatuo Energy Group Co Ltd	China
Beijing Datang Power Fuel Co Ltd	China
Beijing Energy Holding Co Ltd	China
Beijing Guodian Power Co Ltd	China
Beijing Haohua Energy Resource Co Ltd 	China
Beijing Jingmei Group Co Ltd	China
Beijing Jingneng Power Co Ltd	China
Bejing Energy Shiyan Thermo Power Co	China
Belmont County Coal Resources Inc	USA
Bengal Birbhum Coalfields Ltd	India
Bengalla Mining Co Pty Ltd	Australia
Berkshire Hathaway Energy Co	USA
Best Coal Co SAS	Colombia
Best Coal Inc	USA
Bharat Coking Coal Ltd 	India
Bharat Heavy Electricals Ltd	India
Bhartiya Rail Bijlee Co Ltd	India
Bhatia Energy and Minerals Pvt Ltd	India
Bhira Investments Pte Ltd	Mauritius
BHP Billiton Finance BV	Netherlands
BHP Billiton Finance Ltd	Australia
BHP Billiton Finance plc	United Kingdom
BHP Billiton Finance (USA) Ltd	Australia
BHP Finance Ltd	United Kingdom
BHP Group Ltd	Australia
BHP Group plc	United Kingdom
Bhubaneshwar Power Private Ltd 	India
Bhubaneswari Coal Mining Ltd	India
Big Ben Holdings Pty Ltd (Bloomfield Group)	Australia
Big Rivers Electric Corp	USA
Bihar Infrapower Ltd	India
Bihar Mega Power Ltd	India
Bin County Coal Co Ltd	China
Birchfield Coal Mines Ltd	New Zealand
Bisichi Coal Mining (Pty) Ltd	South Africa
Bisichi Mining (Exploration) Ltd	United Kingdom
Bisichi PLC	United Kingdom
Black Butte Coal Co	USA
Black Cockatoo Holdings Pty Ltd	Australia
Blackfin Pty Ltd	Australia
BlackGold Asia Resources Pte Ltd (Singapore)	Singapore
BlackGold Energy Ltd (Hong Kong)	China (Hong Kong)
Blackgold Natural Resources Ltd	Singapore
BlackGold Power Pte Ltd (Singapore)	Singapore
Blackhawk Mining LLC	USA
Black Hills Corp	USA
Black Royalty Minerals Pty Ltd	South Africa
Black Wattle Colliery (Pty) Ltd	South Africa
Black Wattle Klipfontein (Pty) Ltd	South Africa
BLCP Power Ltd	Thailand
BLCP Power Ltd	Thailand
Bloomfield Collieries Pty Ltd	Australia
Blue Mountain Energy Inc	USA
Bluewaters Power 1 Pty Ltd	Australia
Bluewaters Power 2 Pty Ltd	Australia
BNI Coal Ltd	USA
BNI Energy Inc	USA
Board of Municipal Utilities of Sikeston	USA
Bodal Chemicals Ltd	India
Bodi International LLC	Mongolia
Bogatyr Coal LLP	Kazakhstan
Bogatyr Coal LLP	Kazakhstan
Boggabri Coal Operations Pty Ltd	Australia
Boggabri Coal Pty Ltd	Australia
Bokaro Power Supply Co Ltd	India
Bokaro Power Supply Co Ltd	India
Bonanza Energy Resources Inc 	Philippines
Botswana Power Corp (BPC)	Botswana
Botswana Railways	Botswana
Botum Sakor Energy Co Ltd	Cambodia
Boulder Stone Mart Pvt Ltd	India
Bowen Coking Coal Ltd	Australia
Bowen Rail Co Pty Ltd	Australia
Bravus Mining and Resources	Australia
Bridger Coal Co	USA
Bridger Coal Co	USA
Brikel EAD	Bulgaria
Brook Mining Co LLC	USA
BS Energy (Braunschweiger Versorgungs-AG & Co KG)	Germany
BS Ispat Ltd	India
Buckeye Power Inc	USA
Buckskin Mining Co	USA
Bulga Coal Management Pty Ltd	Australia
Bulgarian Energy Holding (BEH)	Bulgaria
Bulk Trading SA	Switzerland
Bushveld Minerals Ltd	South Africa
B&W Resources Inc	USA
Byerwen Coal Pty Ltd	Australia
Cambodia Energy Ltd (CEL)	Cambodia
Cambodia Energy Ltd II (CEL2)	Cambodia
Cambodia International Investment Development Group Co Ltd	Cambodia
Canadian Kailuan Dehua Mines Co Ltd	Canada
Can Komur ve Insaat AS	Turkey
Canyon Coal Pty Ltd	South Africa
Canyon Fuel Co LLC	USA
Cao Son Coal JSC -TKV	Vietnam
Capital Power Corp	Canada
Capital Power LP	Canada
Carbones del Cerrejon Ltd	Colombia
Carbones Guri Guri	Venezuela
Carbonífera Catarinense Ltda	Brazil
Carbonifera Metropolitana SA 	Brazil
Carbonífera Siderópolis Ltda	Brazil
Carbo One Ltd	Cyprus
CARGOSPED TERMINAL BRANIEWO Sp z o o	Poland
Carmichael Rail Network Pty Ltd	Australia
Castle Peak Power Co Ltd	China (Hong Kong)
Castle Peak Power Co Ltd	China (Hong Kong)
Castle Peak Power Finance Co Ltd	China (Hong Kong)
Castle Peak Power Finance Co Ltd	China (Hong Kong)
CATES Elektrik Uretim AS	Turkey
CC Kolmar LLC	Russia
CCS Supply Chain Management Co Ltd	China
Cebu Energy Development Corp 	Philippines
Cebu Energy Development Corp 	Philippines
Cebu Energy Development Corp 	Philippines
Cebu Energy Development Corp 	Philippines
Cebu Energy Development Corp 	Philippines
Celikler Holding	Turkey
Cenal Elektrik Uretim AS	Turkey
Centennial Coal Co Pty Ltd	Australia
Center Coal Co	USA
CenterPoint Energy Inc	USA
Central Asian Electric Power Corp JSC	Kazakhstan
Central Coalfields Ltd	India
Central Queensland Coal Pty Ltd	Australia
CESC Ltd	India
Ceylon Electricity Board	Sri Lanka
CEZ AS	Czech Republic
CEZ Finance BV	Netherlands
CEZ Polska Sp z o o	Poland
CFM - Portos e Caminhos de Ferro de Mocambique	Mozambique
CG Natural Resources Pvt Ltd	India
CH4 Drilling Pty Ltd	Australia
Chain Valley Colliery 	Australia
Chandgana Coal LLC 	Mongolia
Chandra Prabhu International Ltd 	India
Changchun Dahua Cogeneration Co Ltd	China
Chattisgarh East Railway Ltd	India
Chattisgarh East-West Railway Ltd	India
CHD Power Plant Operation Co Ltd	China
Chenbaerhuqi Tianshun Mining Industry Co Ltd	China
Chhattisgarh State Power Distribution Co Ltd	India
Chhattisgarh State Power Generation Co Ltd 	India
Chhattisgarh State Power Holding Co Ltd	India
Chhattisgarh State Power Transmission Co Ltd	India
Chifeng Economic Development Zone Power Generation Co Ltd	China
Chilota Colliery Co Pvt Ltd	Zimbabwe
"	China
China Coal Energy Co Ltd	China
China Coal Energy Hami Coal Industry Co Ltd	China
China Coal Energy Xinjiang Coal Electricity Co Ltd	China
China Coal Energy Xinjiang Hongxin Coal Industry Co Ltd	China
China Coal Energy Xinjiang Tianshan Coal Power Co Ltd	China
China Coal Huali Energy Holdings Ltd	China
China Coal Jinzhong Energy Chemical Co Ltd	China
China Coal Northwest Energy Co Ltd	China
China Coal Ordos Energy Chemical Co Ltd	China
China Coal Pingshuo Coal Co Ltd	China
China Coal Resources Development Group Co Ltd	China
China Coal Sales Transportation Co Ltd	China
China Coal Shaanxi Yulin Energy Chemical Co Ltd	China
ChinaCoal Shanxi Huayu Energy	China
China Coal Technology & Engineering Group Co	China
China Coal Xinji Energy Co Ltd	China
China Coal Xinji Energy Co Ltd	China
China Coal Xinji Fuyang Mining Co Ltd	China
China Coal Xinji Liuzhuang Mining Co Ltd	China
China Coal Xinji Lixin Power Generation Co Ltd	China
China Coal Yili Energy Development Co Ltd	China
China Coal Yili Energy Development Co Ltd	China
China Datang Corp	China
China Datang Energy Investment Co Ltd	China
China Energy Engineering Co Ltd (Energy China)	China
China Energy Engineering Group Co Ltd (Energy China Group)	China
China Energy Group Ningxia Coal Industry Co Ltd	China
China Energy Group Wuhai Energy Co Ltd	China
China Energy Investment Corp (China Energy/ CHN Energy)	China
China Huadian Capital Holdings Co Ltd	China
China Huadian Co Ltd	China
China Huadian Finance Co Ltd	China
China Huadian Group Harbin Power Generation Co Ltd	China
China Huadian Hong Kong Co Ltd	China
China Huadian Overseas Asset Management Co Ltd	China (Hong Kong)
China Huadian Overseas Development 2018 Ltd	China
China Huaneng Finance Co	China
China Huaneng Group Co Ltd	China
China Huaneng Group Fuel Co Ltd	China
China Huaneng Group (Hong Kong) Treasury Management Holding Ltd	China
China Kingho Energy Group Co Ltd	China
China Leon Inspection Holding Ltd	China
China Longyuan Power Group Co Ltd	China
China National Coal Development Co Ltd	China
China National Coal Group Corp (ChinaCoal)	China
China National Coal Mining Equipment Co Ltd	China
China National Machinery Import and Export Corp (CMC)	China
China Natural Resources Inc	China (Hong Kong)
China Oceanwide Holdings Ltd	China (Hong Kong)
China Petrochemical Corp (Sinopec Corp)	China
China Petrochemical Group (Sinopec Group)	China
China Pingmei Shenma Group	China
China Power Finance Co Ltd	China
China Power Hub Generation Co Pvt Ltd	Pakistan
China Power Hub Generation Co Pvt Ltd	Pakistan
China Power International Development Ltd	China (Hong Kong)
China Qinfa Group Ltd	China
China Railway Resources Sunitezuoqi Manglai Surface Mine Co Ltd	China
China Resources Coal Holdings Corp Ltd	China
China Resources Power Holdings Co Ltd	China
China Resources Power Hubei Co Ltd	China
China Resources Power (Xiantao) Co Ltd	China
China Resources Power (Xilinguole) Coal Industry Co Ltd	China
China Resources Power (Zhejiang) Co Ltd	China
China Shenhua Coal to Liquid and Chemical Co Ltd	China
China Shenhua Energy Co Ltd (CSEC/China Shenhua)	China
China Sinogy Electric Group Co Ltd	China
China Southern Power Grid Co Ltd	China
China Southern Power Grid International Co Ltd	China (Hong Kong)
China XLX Fertiliser Ltd	China
CHN China Guohua Power Co Ltd	China
CHN Energy Baoqing Coal Power Co Ltd	China
CHN Energy Baotou Mining Co Ltd	China
CHN Energy Boxing Power Co Ltd	China
CHN Energy Changyuan Electric Power Co Ltd	China
CHN Energy Changyuan Electric Power Co Ltd	China
CHN Energy Fujian Energy Co Ltd	China
CHN Energy Guoyuan Power Co Ltd	China
CHN Energy Hangjin Energy Co Ltd	China
CHN Energy Henan Power Co Ltd	China
CHN Energy Huabei Power Generation Co Ltd	China
CHN Energy Inner Mongolia Power Co Ltd	China
CHN Energy Jiangxi Power Generation Co Ltd	China
CHN Energy Ledong Power Co Ltd	China
CHN Energy Liaoning Electric Power Co Ltd	China
CHN Energy Ningxia Power Co Ltd	China
CHN Energy Shaanxi Power Co Ltd	China
CHN Energy Shaanxi Shenyan Coal Co Ltd 	China
CHN Energy  Sichuan Power Generation Co Ltd	China
CHN Energy Xinjiang Energy Co Ltd	China
CHN Energy Xinjiang Shenhua Mining Co Ltd	China
CHN Energy Yunnan Power Co Ltd	China
ChongQing SongZao Sembcorp Electric Power Co Ltd	China
ChongQing SongZao Sembcorp Electric Power Co Ltd	China
Chowgule & Co Pvt Ltd	India
Chubu Electric Power Co Inc	Japan
Chugoku Electric Power Australia Resources Pty Ltd	Australia
Chugoku Electric Power Co Inc	Japan
CIHC Pak Power Co Ltd 	Pakistan
CIIDG Erdos Hongjun Electric Power Co Ltd 	China
CIIDG Erdos Hongjun Electric Power Co Ltd 	China
Ciner Group (Park Holding AS)	Turkey
CITIC Ltd	China (Hong Kong)
City of Fremont Department of Utilities	USA
City of Grand Island Utilities Department	USA
City of Hastings Utility Department	USA
City Utilities of Springfield	USA
Clean Coal Enterprises Pvt Ltd	India
Cleco Cajun LLC	USA
Cleco Corporate Holdings LLC	USA
Cleco Power LLC	USA
CLP Guangxi Fangchenggang Power Co Ltd	China
CLP Holdings Ltd	China (Hong Kong)
CLP Power Hong Kong Financing Ltd	China (Hong Kong)
CLP Power International Ltd 	China (Hong Kong)
CLP Ronghe Investment and Financial Leasing Co Ltd	China
Clyde Park Coal Pty Ltd	Australia
CMC - Coal Marketing Co Ltd	Ireland
CMS Energy Corp	USA
CMS Investment Generation Comp	USA
CMT Liquids Terminal LLC	USA
Coal & Allied Industries Ltd	Australia
Coal & Allied Industries Ltd	Australia
Coal Asia Holdings Inc	Philippines
Coal Energy SA	Ukraine
Coal Import Export JSC	Vietnam
Coal India Africana Limitada 	India
Coal India Ltd	India
Coal Mining Madagascar SARL	Madagascar
Coal Network LLC	USA
Coal & Oil Co LLC	United Arab Emirates
Coal & Oil Group	United Arab Emirates
Coal Orbis Trading GmbH	Germany
Coal Power Generation Co Bangladesh Ltd	Bangladesh
Coalsale Co Ltd	India
Coal Services as	Czech Republic
Coal Services Pty Ltd	Australia
Coalspur Mines (Holdings) Pty Ltd	Australia
Coalspur Mines (Operations) Ltd	Canada
Coalspur Mines Pty Ltd	Australia
Coal Star Co Ltd	Russia
Coastal Energen Pvt Ltd	India
Coeclerici Far East Pte Ltd 	Singapore
Coeclerici SpA	Italy
Colombian Natural Resources SAS	Colombia
Colowyo Coal Co LP	USA
Comet Coal & Coke Pty Ltd	Australia
Community Investment Holdings Pty Ltd	South Africa
Companhia Riograndense de Mineracao	Brazil
Complexul Energetic Oltenia SA	Romania
Comsar Energy Group Ltd	Cyprus
Comsar Energy Republika Srpska	Bosnia and Herzegovina
Comsar Energy Republika Srpska	Bosnia and Herzegovina
Cong Thanh Cement JSC	Vietnam
Cong Thanh Thermal Power JSC	Vietnam
CONSOL Coal Resources LP	USA
CONSOL Energy Inc	USA
Consol Funding LLC	USA
CONSOL Marine Terminals LLC	USA
Consumers Energy Co Finance III	USA
Consumers Energy Co Finance II	USA
Consumers Energy Co Finance IV	USA
Consumers Energy Co	USA
Consumers Power Co Financing I	USA
Copelmi Mineração Ltda	Brazil
Corn Belt Power Cooperative	USA
Cornwall Coal Co Pty Ltd	Australia
Corporación Dominicana de Empresas Eléctricas Estatales	Dominican Republic
Corredor de Desenvolvimento Integrado do Zambeze (Codiza)	Mozambique
County International Ltd	Australia
Coyote Creek Mining Co LLC	USA
CPE: China Energy Engineering Group Planning and Engineering Co Ltd	China
CR & CNIC Investment Ltd	China
Crescent Power Ltd 	India
Crown Coal & Coke Co	USA
CR Power Investment Co Ltd	China
CSEC Guohua International Power Co Ltd	China
CSEC Guohua International Power Co Ltd	China
CS Energy Ltd	Australia
CSW CREDIT INC	USA
Daguma Agro Minerals Inc 	Philippines
Dairyland Power Cooperative	USA
Dakota Coal Co	USA
Dakota Gasification Co	USA
Dalian City Thermoelectric Group Co Ltd	China
Dalian Guohong Thermal Power Group Co Ltd	China
Dalian Thermal Power Co Ltd	China
Dalian Thermal Power Co Ltd	China
Dalmia Cement Bharat Ltd	India
Dalrymple Bay Finance Pty Ltd	Australia
Daltransugol JSC 	Russia
Damodar Valley Corp	India
Daqin Railway Co Ltd	China
Datang Anhui Power Generation Co Ltd 	China
Datang Environment Industry Group Co Ltd	China
Datang Fengyang Xiaogang Village Energy Co Ltd	China
Datang Fengyang Xiaogang Village Energy Co Ltd	China
Datang Gansu Power Generation Co Ltd	China
Datang Guizhou Power Generation Co Ltd	China
Datang Hebei Power Generation Co Ltd	China
Datang Heilongjiang Power Generation Co Ltd	China
Datang Henan Power Generation Co Ltd	China
Datang Huayin Electric Power Co Ltd (Datang Hunan)	China
Datang Huayin Zhuzhou Power Generation Co Ltd	China
Datang International Power Generation Co Ltd	China
Datang International Power Generation Co Ltd	China
Datang Jiangsu Power Generation Co Ltd	China
Datang Jilin Power Generation Co Ltd	China
Datang Jingjinji Energy Development Co Ltd	China
Datang Luoyang Shouyangshan Power Generation Co Ltd	China
Datang Power Fuel Co Ltd	China
Datang Pucheng Power Co Ltd	China
Datang Sanmenxia Power Generation Co Ltd	China
Datang Shaanxi Power Generation Co Ltd	China
Datang Shandong Power Generation Co Ltd	China
Datang Xiangtan Power Generation Co Ltd	China
Datang Xinjiang Power Generation Co Ltd	China
Datong Coal Mine Group Linfen Hongda Mining Co Ltd	China
Datun Coal and Electricity (Group) Co Ltd	China
DBCT Management Pty Ltd	Australia
DB Power Ltd	India
Dedicated Freight Corridor Corp of India Ltd	India
Dedicoal Pty Ltd	South Africa
Defas Madencilik San ve Tic AS	Turkey
Dellworth Pty Ltd	Australia
Demery Resources Co LLC	USA
Demir Export AS	Turkey
Deoghar Infra Ltd	India
Deoghar Mega Power Ltd	India
Deo Nai Coal JSC	Vietnam
Deseret Generation And Transmission Cooperative	USA
Dhariwal Infrastructure Ltd 	India
Dianjian International Finance Ltd	China
Diler Elektrik Uretim AS	Turkey
Diler Holding	Turkey
Diliigent Power Pvt Ltd	India
DLs Trading	Indonesia
DMCI Holdings Inc	Philippines
Dogrudan Elektrik Enerjisi Toptan Satis ve Tedarik AS	Turkey
Dominion Energy Inc	USA
Dominion Energy South Carolina Inc	USA
Donbasenergo PJSC	Ukraine
Dongfang Electric Co Ltd (DEC-Ltd)	China
Dongguang Chemical Ltd	China
Dongying Binhai Thermal Power Co Ltd	China
Dongying Haixin Thermal Supply Co Ltd	China
Doosan Enerbility Co Ltd	South Korea
Doosan Power Systems India Pvt Ltd	India
DPL Capital Trust II	USA
DPL Inc	USA
Drake Mine Management Pty Ltd	Australia
Drummond Co Inc	USA
Drummond Ltd	Colombia
DTE CAPITAL CORP	USA
DTE Electric Co	USA
DTE Energy Co	USA
DTEK BV Group	Ukraine
DTEK Dniproenergo JSC	Ukraine
DTEK Dobropolyeugol LLC	Ukraine
DTEK Energy BV	Ukraine
DTEK FINANCE BV	Netherlands
DTEK FINANCE PLC	United Kingdom
DTEK Pavlogradugol PJSC	Ukraine
DTEK Westenergy JSC	Ukraine
Duke Capital Finance Trust II	USA
Duke Capital Finance Trust I	USA
Duke Energy Capital Trust II	USA
Duke Energy Carolinas LLC	USA
Duke Energy Corp	USA
Duke Energy Florida Project Finance LLC	USA
Duke Energy Indiana Inc	USA
Duke Energy Kentucky Inc	USA
Duke Energy Ohio Inc	USA
Duke Energy Progress LLC	USA
Eagle Specialty Materials LLC	USA
East Coast Energy Pvt Ltd	India
East Energy Resources Ltd	Australia
Eastern Coalfields Ltd	India
Eastern Pearl Co Ltd	Thailand
East Kentucky Power Cooperative Inc	USA
East Mining Co LLC	Russia
E-Commodities Holdings Ltd	China (Hong Kong)
Edenville Energy Plc	United Kingdom
Edenville International (Tanzania) Ltd	Tanzania
EDP Energias do Brasil SA	Brazil
EDP Espana SAU	Spain
EDP Servicios Financieros Espana SAU	Spain
EFT Rudnik i Termoelektrana Stanari doo	Bosnia and Herzegovina
EGAT International Co Ltd 	Thailand
Eins Energie in Sachsen GmbH & Co KG 	Germany
Ekibastuz GRES-2 JSC	Kazakhstan
Electric Energy Inc	USA
Electricity Generating Authority of Thailand (EGAT)	Thailand
Electricity Generating Public Co Ltd (EGCO Group)	Thailand
Electricity Generating Public Co Ltd (EGCO Group)	Thailand
Electricity Generation and Retail Corp (Synergy)	Australia
Electricity Generation Co Malawi Ltd	Malawi
Elektrik Uretim AS Genel Mudurlugu (EUAS)	Turkey
Elektrocieplownia Bedzin SA	Poland
Elektrocieplownia BEDZIN Sp z o o	Poland
Elektroprivreda Crne Gore AD Niksic	Montenegro
Elektroprivreda Republike Srpske (ERS)	Bosnia and Herzegovina
Elektroprivreda Srbije (EPS)	Serbia
Elektrownia Ostroleka SA	Poland
Elektrownia Patnow II Sp z o o	Poland
Elga Coal Complex	Russia
Elgin Karbon Emtia Ltd Sti	Turkey
ELGOR + HANSEN	Poland
Elion Clean Energy Co Ltd	China
Elion Clean Energy Co Ltd	China
Elk Ridge Mining and Reclamation LLC 	USA
Elm Road Generating Station Supercritical LLC	USA
Eloff Agriculture and Mining Company Pty Ltd	South Africa
Eloff Agriculture and Mining Company Pty Ltd	South Africa
EMBA Electricity Production Co Inc	Turkey
Emera Inc	Canada
Emery County Coal Resources Inc	USA
EMIL Mines And Mineral Resources Ltd	India
Empresa Electrica Angamos SA	Chile
Empresa Electrica Cochrane SpA	Chile
Empresa Electrica Guacolda SA	Chile
Empresa Generadora de Electricidad Itabo SA	Dominican Republic
EnBW Energie Baden-Württemberg AG	Germany
EnBW International Finance BV	Netherlands
Endesa Capital SA 	Spain
Endesa Financiación Filiales SA	Spain
Enea Elektrownia Polaniec SA	Poland
Enea SA	Poland
Enea Wytwarzanie SA	Poland
Enegra Group Ltd	Malaysia
Enel Finance America LLC	USA
Enel Finance International NV	Netherlands
Enel Investment Holding BV	Netherlands
Enel SpA	Italy
ENERGA Finance AB	Sweden
Energa SA	Poland
Energeticky a prumyslovy holding as (EPH)	Czech Republic
Energeticky a prumyslovy holding as (EPH)	Czech Republic
Energeticky a prumyslovy holding as (EPH)	Czech Republic
Energetika Ljubljana doo	Slovenia
Energo-Utech SA 	Poland
EnergyAustralia Finance Pty Ltd	Australia
EnergyAustralia Pty Ltd	Australia
Energy Harbor Corp	USA
Energy Harbor Generation LLC	USA
Eneva SA	Brazil
Enex Oakbridge Pty Ltd	Australia
Engie Energia Chile SA	Chile
Engro Energy Ltd	Pakistan
Engro Powergen Thar Private Ltd 	Pakistan
EN+ Group IPJSC	Russia
ENRC FINANCE LTD	United Kingdom
Ensham Resources Pty Ltd	Australia
Ensham Resources Pty Ltd	Australia
EP Corporate Group, as	Czech Republic
EP Energy as	Czech Republic
EP France SAS	France
EPH Financing CZ as	Czech Republic
EPH Financing SK as	Slovakia
EP Infrastructure as (EPIF)	Czech Republic
EP Kilroot Ltd	United Kingdom
EP Power Europe as (EPPE)	Czech Republic
EP Produzione SpA	Italy
EP Resources CZ as	Czech Republic
Erdenes Asset Management LLC	Mongolia
Erdenes Mongol LLC	Mongolia
Erdenes Shivee Energy LLC	Mongolia
Erdenes Shivee Energy LLC	Mongolia
Erdenes Tavan Tolgoi JSC 	Mongolia
Erdos Hongsen Mining Co Ltd	China
Erdos Shuangxin Electric Power Co Ltd	China
Erdos Yingpanhao Coal Industry Co Ltd	China
Eren Enerji Elektrik Uretim AS 	Turkey
Eren Holding AS	Turkey
Eskom Finance Co SOC Ltd	South Africa
Eskom Holdings SOC Ltd	South Africa
Essar Ports Ltd	India
Essar Ports & Terminals Ltd	Mauritius
Essar Power Gujarat Ltd	India
Essar Power Hazira Ltd	India
Essar Power Ltd	India
Essel Mining & Industries Ltd	India
Essence International Financial Holdings Ltd	China (Hong Kong)
Esta Group AG	Switzerland
Eswatini Electricity Co	Eswatini
Eurasian Energy Corporation JSC (EEC)	Kazakhstan
Eurasian Resources Group Sarl (ERG)	Luxembourg
Evergy Inc	USA
Evergy Kansas Central Inc	USA
Evergy Kansas South Inc	USA
Evergy Metro Inc	USA
Evergy Missouri West Inc	USA
Evolution Power Investment Corp	Singapore
Excalibur Power LLC	USA
Exxaro Resources Ltd	South Africa
Facor Power Ltd	India
Fairmine Carbons Pvt Ltd	India
FAMAK SA	Poland
Famur Finance sp zoo	Poland
Famur SA	Poland
Far Eastern Generating Co JSC	Russia
FDC Misamis Power Corp	Philippines
FDC Utilities Inc	Philippines
FEDERAL INTL FINANCE	Indonesia
Feicheng Mining Group Co Ltd	China
Feicheng Mining Group Liangbaosi Energy Co Ltd	China
Feishang Anthracite Resources Ltd	China
Feishang Group Ltd	China
Ferrocarriles del Norte de Colombia SA	Colombia
Ferrovia Tereza Cristina SA	Brazil
FFBL Power Co Ltd 	Pakistan
Filinvest Development Corp	Philippines
Filiz Kirazlıdere Enerji Uretim AS	Turkey
Finges Investment BV	Netherlands
FirstEnergy Corp	USA
First Pacific Co Ltd	China (Hong Kong)
Fiume Santo SpA	Italy
FM Coal LLC	USA
Foresight Energy LP	USA
Formosa Ha Tinh Steel Corp	Vietnam
Formosa Heavy Industries Corp	Taiwan
Formosa Petrochemical Corp (FPCC)	Taiwan
Formosa Plastics Corp	Taiwan
Fortis Inc	Canada
Fortum Oyj	Finland
Forum Muider BV	Netherlands
Four Mile Pty Ltd	Australia
FPC Capital Ltd	China (Hong Kong)
FPC Treasury Ltd	China (Hong Kong)
FTB (QLD) Pty Ltd	Australia
Fugu State-owned Assets Management Bureau	China
Fujian Datang International Ningde Power Generation Co Ltd	China
Fujian Energy Group Co Ltd	China
Fujian Funeng Co Ltd	China
Fujian Hongshan Thermal Power Co Ltd	China
Fujian Huadian Furui Energy Development Co Ltd 	China
Fujian Huadian Kemen Power Generation Co Ltd	China
Fujian Huadian Shaowu Energy Co Ltd	China
Fujian Huadian Yongan Power Generation Co Ltd	China
Fujian Hui'an Quanhui Power Generation Co Ltd	China
Gabriella Mineração Ltda	Brazil
Galilee Power Pty Ltd	Australia
Gangneung Eco Power Co Ltd	South Korea
Gangneung Eco Power Co Ltd	South Korea
Gansu Energy Chemical Investment Group Co Ltd	China
Gansu Energy Group Co Ltd	China
Gansu Jingyuan Coal Industry and Electricity Power Co Ltd	China
Gansu Jingyuan Coal Industry and Electricity Power Co Ltd	China
Gansu Lingnan Coal Industry Co Ltd	China
Gansu Province Electric Power Investment Group Co Ltd (GEPIC)	China
Gansu Wansheng Mining Co Ltd	China
Gazel Energie Generation SAS	France
GCM Resources plc	United Kingdom
GD Power Chaoyang Thermal Power Co Ltd	China
GD Power Dalian Zhuanghe Power Generation Co Ltd	China
GD Power Datong Power Generation Co Ltd	China
GD Power Datong Power Generation Co Ltd	China
GD Power Development Co Ltd	China
GD Power Handan Dongjiao Thermal Power Co Ltd	China
Gecelca SAESP	Colombia
Geely Baikuang Mining Group Co Ltd	China
Gemeng International Energy Co Ltd	China
Gemeng International Energy Co Ltd	China
Genesis Energy Ltd	New Zealand
Genting Power Holdings Ltd	Malaysia
Geo Energy Resources Ltd	Singapore
Georgia Power Capital LP	USA
Georgia Power Capital Trust III	USA
Georgia Power Capital Trust II	USA
Georgia Power Capital Trust	USA
Georgia Power Capital Trust VII	USA
Georgia Power Capital Trust VI	USA
Georgia Power Capital Trust V	USA
Georgia Power Co	USA
GEPIC Changle Power Generation Co Ltd	China
GEPIC Jinchang Power Co Ltd	China
GEPIC Wuwei Power Generation Co Ltd	China
GEPIC Zhangye Power Generation Co Ltd	China
Gladstone Ports Corp Ltd	Australia
Glencore Australia Investment Holdings Pty  Ltd	Australia
Glencore Capital Finance DAC	Ireland
Glencore Finance (Bermuda) Ltd	Bermuda
Glencore Finance (Europe) Ltd	Jersey
Glencore Funding LLC	USA
Glencore Group Funding Ltd	United Arab Emirates
Glencore Investment Pty Ltd	Australia
Glencore Operations Australia Pty Ltd	Australia
Glencore PLC	Switzerland
Glencore Queensland Ltd	Australia
Glencore (Schweiz) AG	Switzerland
Global Aluminium International Pte Ltd	Indonesia
Global Business Power Corp 	Philippines
Global Business Power Corp 	Philippines
Global Business Power Corp 	Philippines
Global Business Power Corp 	Philippines
Global Coal & Mining Pvt Ltd	India
Global Coal Sales Group LLC	USA
Global Commodities Holdings Ltd	Australia
Global Energy Minerals Sdn Bhd	Malaysia
Global Mining Group LLC	USA
Global Mining Holding Co LLC	USA
Globaltrans Investment PLC	Russia
Glow Energy Public Co Ltd	Thailand
GMR Energy Ltd	India
GMR Energy Ltd	India
GMR Energy (Netherlands) BV	Netherlands
GMR Infrastructure Ltd	India
GMR Infrastructure Singapore Pvt Ltd	Singapore
GMR Kamalanga Energy Ltd 	India
GMR Warora Energy Ltd	India
GNPower Dinginin Ltd Co	Philippines
GNPower Dinginin Ltd Co	Philippines
GN Power Kauswagan Ltd Co	Philippines
GNPower Mariveles Energy Center Co Ltd	Philippines
GOCL Corp Ltd	India
Goedgevonden Joint Venture	South Africa
Golden Energy and Resources Ltd	Singapore
Golden Lake Co Ltd	Myanmar
Golden Valley Electric Association	USA
Gongzhuling Longsheng Thermal Power Co Ltd	China
Goseong Green Power Co Ltd	South Korea
Goseong Green Power Co Ltd	South Korea
GPU CAPITAL INC	USA
Grand Ocean Advanced Resources Co Ltd	China
Grand River Dam Authority	USA
Granite Shore Power LLC	USA
Graspan Colliery Pty Ltd	South Africa
Great Southern Energy Pty Ltd (Delta Coal)	Australia
Green Leader Holdings Group Ltd	China
Grindrod Ltd	South Africa
Grindrod Mozambique Ltd	Mozambique
Grosskraftwerk Mannheim AG	Germany
Grosskraftwerk Mannheim AG	Germany
Grupa Azoty SA	Poland
GS Donghae Electric Power Co Ltd	South Korea
GS Donghae Electric Power Co Ltd	South Korea
GS E&R Corp	South Korea
GS Pocheon CHP Corp	South Korea
Guacolda Energia SA	Chile
Guangdong Baolihua Electry Power Co Ltd	China
Guangdong Baolihua New Energy Stock Co	China
Guangdong China Coal Import and Export Co Ltd	China
Guangdong Datang International Chaozhou Power Generation Co Ltd	China
Guangdong Datang International Leizhou Power Generation Co Ltd	China
Guangdong Electric Power Development Co Ltd	China
Guangdong Energy Group Co Ltd	China
Guangdong Energy Group Guizhou Co Ltd	China
Guangdong Huadian Shaoguan Thermal Power Co Ltd	China
Guangdong Huaxia Energy Investment Ltd	China
Guangdong Huaxia Power Development Co Ltd	China
Guangdong Investment Ltd	China
Guangdong King Sun Electric Power Group Ltd	China
Guangdong Yudean Dabu power Generation Co Ltd	China
Guangdong Zhuhai Jinwan Power Company Ltd 	China
Guangdong Zhuhai Power Station Company Ltd	China
Guangdong Zhujiang Investment Management Group Co Ltd	China
Guanghui Energy Co Ltd	China
Guangxi Guangtou Energy Co Ltd	China
Guangxi Guidong Electric Power Co Ltd	China
Guangxi Guidong Electric Power Co Ltd	China
Guangxi Guiguan Electric Power	China
Guangxi Investment Group Beihai Power Generation Co	China
Guangxi Investment Group Co Ltd	China
Guangzhou Development Group Co Ltd (GDG)	China
Guangzhou Dongfang Power Co Ltd	China
Guangzhou Hengyun Enterprises Holding Ltd	China
Guangzhou Pearl River Power Co Ltd	China
Guiyang Energy (Group) Co Ltd	China
Guiyang Energy Group Hezhang Power Co Ltd	China
Guizhou Anlong Xinyu Resources Development Co	China
Guizhou Dafang Power Co	China
Guizhou Jinzhou Power Co Ltd	China
Guizhou Longfeng Coal Co Ltd	China
Guizhou Panjiang Coal And Electricity Group Co Ltd	China
Guizhou Panjiang Hengpu Coal Industry Co Ltd	China
Guizhou Panjiang Refined Coal Co Ltd	China
Guizhou Panzhou Yinhe Mining Company	China
Guizhou Qiandong Power Co Ltd	China
Guizhou Shuicheng Mining Co Ltd	China
Guizhou Shuikuang Holding Group Co Ltd	China
Guizhou Tianrun Mining Co Ltd	China
Guizhou Wenjiaba Mining Co Ltd	China
Guizhou Xingyi Electric Power Development Co Ltd	China
Guizhou Xingyi Yangguang Assets Management Group Co Ltd	China
Guizhou Xishui Dingtai Energy Development Co Ltd 	China
Guizhou Yueqian Power Co Ltd 	China
Guizhou Zhongshan Yemazhai Power Generation Co Ltd	China
Gujarat Industries Power Co Ltd	India
Gujarat Industries Power Co Ltd	India
Gujarat Mineral Development Corp Ltd	India
Gujarat State Electricity Corp Ltd 	India
Gujarat Urja Vikas Nigam Ltd	India
Gulf Coal Trading LLC	United Arab Emirates
Guodian Anhui Power Co Ltd	China
Guodian (Beijing) International Power Energy Co Ltd	China
Guodian Guizhou Coal Industry Investment Co Ltd	China
Guodian Inner Mongolia Dongsheng Co-Generation Power Co Ltd	China
Guodian Inner Mongolia Energy Co Ltd	China
Guodian & Jiantou Inner Mongolia Energy Investment Co Ltd	China
Guodian Power Shuangwei Inner Mongolia Shanghaimiao Energy Co Ltd	China
Guodian Yongshou Coal Industry Co Ltd	China
Guoneng Baorixile Energy Industrial Co Ltd 	China
Guoneng Changyuan Hanchuan Power Generation Co Ltd	China
Guoneng Changzhou Power Co Ltd 	China
Guoneng Chengdu Jintang Power Co Ltd	China
Guoneng Chenjiagang Power Generation Co Ltd	China
Guoneng Dawukou Thermal Power Co Ltd	China
Guoneng Fengcheng Power Generation Co Ltd	China
Guoneng Fuzhou Thermal Power Co Ltd	China
Guoneng Inner Mongolia Guohua Hulun Buir Power Generation Co Ltd 更新股权结构	China
Guoneng Jiangsu Jianbi Power Generation Co Ltd	China
Guoneng Jilin Longhua Thermoelectricity Co Ltd	China
Guoneng Mengjin Electric Power Co Ltd	China
Guoneng Ningdong No.1 Power Generation Co Ltd	China
Guoneng Ningxia Lingwu Power Generation Co Ltd	China
Guoneng Ningxia Shizuishan Power Generation Co Ltd	China
Guoneng Ningxia Shizuishan Power Generation Co Ltd	China
Guoneng Shendong Coal Group Co Ltd	China
Guoneng Shenhua Jiujiang Power Generation Co Ltd	China
Guoneng Shenwan Anqing Power Generation Co Ltd	China
Guoneng Shenwan Chizhou Power Generation Co Ltd	China
Guoneng Shenwan Energy Co Ltd	China
Guoneng Shouguang Power Generation Co Ltd	China
Guoneng Sichuan Energy Co Ltd	China
Guoneng Taicang Power Generation Co Ltd	China
Guoneng Taiyuan No.1 Thermal Power Co Ltd	China
Guoneng Tongling Power Generation Co Ltd	China
Guoneng Xinjiang Hongshaquan Energy Co Ltd	China
Guoneng Xinjiang Power Co Ltd	China
Guoneng Xinjiang Tuokesun Energy Co Ltd	China
Guoneng Xuzhou Power Generation Co Ltd	China
Guoneng Younglight Energy Chemical Group Co Ltd	China
Guoneng Younglight Energy Chemical Group Co Ltd	China
Guoneng Yuedian Taishan Power Generation Co Ltd	China
Guoneng Zhejiang Beilun No. 1 Power Generation Co Ltd	China
Guoneng Zhejiang Beilun No. 1 Power Generation Co Ltd	China
Guoneng Zhejiang Beilun No. 3 Power Generation Co Ltd	China
Guoneng Zhejiang Beilun No. 3 Power Generation Co Ltd	China
Guoneng Zhejiang Ninghai Power Generation Co Ltd	China
Guoneng Zhejiang Ninghai Power Generation Co Ltd	China
Guoneng Zhejiang Zhoushan Power Generation Co Ltd	China
Guoneng Zhenneng Ningdong Power Generation Co Ltd	China
Guoneng Zhenneng Ningdong Power Generation Co Ltd	China
Guoneng Zhunneng Group Co Ltd	China
Guotou Jincheng Energy Investment Co Ltd	China
Guoyuan Times Coal Asset Management Co Ltd	China
Guoyue Investment Group Co Ltd	China
GVK Power (Goindwal Sahib) Ltd	India
Hainan Haide Capital Management Co Ltd	China
Ha Lam Coal JSC	Vietnam
Haldia Energy Ltd 	India
Hallador Energy Co	USA
Hallador Power Co LLC	USA
Hangjinqi Juneng Energy Co Ltd	China
Hanseatic Coal & Trading GmbH	Germany
Han Seng Coal Mine Co Ltd	Cambodia
Hansen Sicherheitstechnik AG	Poland
Harbin Electric Co Ltd	China
Harbin Electric Corp	China
Harbin Electric Corp Jiamusi Electric Machine Co Ltd	China
Harbin Electric International Co Ltd	China
Harbin Hatou Investment Co Ltd	China
Harbin Hatou Investment Co Ltd	China
Harbin Huayue Thermal Power Co Ltd	China
Harbin Investment Group Co Ltd	China
Harrison County Coal Resources Inc	USA
Harum Energy Capital Ltd 	Indonesia
Haryana Power Generation Co Ltd	India
Hattat Enerji and Maden AS	Turkey
Hattat Holding AS	Turkey
Ha Tu Coal JSC	Vietnam
Hebei Construction & Investment Group Co Ltd	China
Hebei Datang International Fengrun Thermal Power Co Ltd	China
Hebei Datang International Qian'an Thermal Power Co Ltd	China
Hebei Datang International Tangshan Beijiao Thermal Power Co Ltd	China
Hebei Datang International Tangshan Thermal Power Co Ltd	China
Hebei Datang International Zhangjiakou Thermal Power Co Ltd	China
Hebei Huadian Shijiazhuang Luhua Thermal Power Co Ltd	China
Hebei Huadian Shijiazhuang Yuhua Thermal Power Co Ltd	China
Hebei Huarui Energy Group Co Ltd	China
Hebei Port Group Co Ltd	China
Hebei Zhuozhou Jingyuan Thermal Power Co Ltd	China
Hebi Coal Industry (Group) Co Ltd	China
Hebi Fenghe Power Generation Co Ltd	China
Hebi Fenghe Power Generation Co Ltd	China
Hebi Zhong Tai Mining Co Ltd	China
Hebi Zhong Tai Mining Co Ltd	China
Hebukesaer Mongolia Autonomous County Xiaolong Coal Mine Co Ltd	China
Heilongjiang Huadian Qiqihar Thermal Power Co Ltd	China
Heilongjiang Longmay Mining Group Co Ltd	China
Heilongjiang Longmay Mining Holding Group Co Ltd	China
Heilongjiang Longmei Mining Group Hegang Co Ltd	China
Heilongjiang Province Xin Ma Thermoelectric Group Co Ltd	China
Helen Ltd	Finland
Hemang Resources Ltd	India
Henan Dayou Energy Co Ltd	China
Henan Energy Group Co Ltd	China
Henan Investment Group Co Ltd	China
Henan Jingneng Huazhou Thermal Power Co Ltd	China
Henan Nengxin Thermal Power Co Ltd	China
Henan Shenhuo Coal & Power Co Ltd	China
Henan Shenhuo Coal & Power Co Ltd	China
Henan Shenhuo Group Co Ltd	China
Henan Tiangong Technology Co Ltd	China
Henan Xuchang Xinlong Mine Industry Co Ltd	China
Henan Yuneng Holdings Co Ltd	China
Hidro-Gen Enerji Ithalat Ihracat Dagitim ve Ticaret AS	Turkey
Hindalco Industries Ltd	India
Hind Energy and Coal Benefication (India) Ltd	India
Hind Multi Services Pvt Ltd	India
Hinduja National Power Corp Ltd	India
Hindustan Powerprojects Pvt Ltd	India
Hiranmaye Energy Ltd	India
Hirono IGCC Power GK	Japan
Hirono IGCC Power GK	Japan
Hitachinaka Generation Co Ltd	Japan
Hitachinaka Generation Co Ltd	Japan
HK Electric Investments	China (Hong Kong)
HMS Bergbau AG 	Germany
Hoboksar Mongol Autonomous County Huadi Mining Co Ltd	China
Hokkaido Electric Power Co Inc	Japan
Hokuriku Electric Power Co	Japan
Hong Kong Electric Finance Ltd	China (Hong Kong)
Hongsa Power Co Ltd	Laos
Hongsa Power Co Ltd	Laos
Hongsa Power Co Ltd	Laos
Hongsa Power Co Ltd	Laos
Hongsa Power Co Ltd	Laos
Ho-Ping Power Co	China (Hong Kong)
Ho-Ping Power Co	Taiwan
Hornonitrianske bane Prievidza (HBP) AS	Slovakia
Houston Industries Financeco LP	USA
HRCM Pty Ltd	Australia
Huadian Coal Industry Group Co Ltd	China
Huadian Energy Co Ltd	China
Huadian Energy Co Ltd	China
Huadian Financial Leasing Co Ltd	China
Huadian Hubei Power Co Ltd	China
Huadian Inner Mongolia Energy Co Ltd	China
Huadian Jiangsu Energy Co Ltd 	China
Huadian Jinshan Energy Co Ltd	China
Huadian Karamay Power Co	China
Huadian Laizhou Power Generation Co Ltd	China
Huadian Longkou Power Co	China
Huadian Luohe Power Generation Co Ltd	China
Huadian Power International Co Ltd	China
Huadian Power International Co Ltd	China
Huadian Qingdao Power Generation Co Ltd	China
Huadian Qudong Power Generation Co Ltd	China
Huadian Shaanxi Energy Co	China
Huadian Shanxi Energy Co	China
Huadian Sichuan Power Generation Co Ltd	China
Huadian Sihanoukville Power Generation Co Ltd	Cambodia
Huadian Tengzhou Xinyuan Thermal Power Co Ltd	China
Huadian Weifang Power Generation Co Ltd	China
Huadian Weifang Power Generation Co Ltd	China
Huadian Xinjiang Power Co Ltd	China
Huadian Xinjiang Zhundong Wucaiwan Power Generation Co Ltd	China
Huadian Xinxiang Power Generation Co Ltd	China
Huadian Yunnan Power Generation Corp	China
Huadian Zhangqiu Power Generation Co Ltd	China
Huadian Zibo Thermopower Generation Co Ltd	China
Huadian Zouxian Power Generation Co Ltd	China
Huaibei GO-ON Power Co Ltd	China
Huaibei Mining Group Co	China
Huaibei Mining Holdings Co Ltd	China
Huaibei Shenwan Power Generation Co Ltd	China
Huaihe Energy (Group) Co Ltd	China
Huaihe Energy Holding Group Co Ltd	China
Huaihu Coal Electricity Co Ltd 	China
Huaihu Coal Electricity Co Ltd 	China
Huainan Huaizhe Coal & Power	China
Huainan Huaizhe Coal & Power	China
Huainan Mining Group Power Generation Co Ltd	China
Huainan Mining Industry Group	China
Huaneng Anyuan Power Generation Co Ltd	China
Huaneng Capital Services Co Ltd	China
Huaneng Coal Co Ltd	China
Huaneng (Dalian) Thermal Power Co Ltd	China
Huaneng Diandong Mining Co Ltd	China
Huaneng Gansu Energy Development Co Ltd	China
Huaneng Guangdong Shantou Electric Co Ltd	China
Huaneng Hainan Power Co Ltd	China
Huaneng Heilongjiang Power Generation Co Ltd	China
Huaneng Hong Kong Capital Ltd	China
Huaneng Huaiyin Second Power Generation Co Ltd	China
Huaneng Hunan Yueyang Power Generation Co Ltd	China
Huaneng Inner Mongolia East Energy Co	China
Huaneng International Power Development Corp	China
Huaneng International Power Fuel Co Ltd	China
Huaneng International Power Jiangsu Energy Development Co Ltd	China
Huaneng Jiaxiang Power Generation Co Ltd	China
Huaneng Jilin Power Co Ltd	China
Huaneng Jilin Power Generation Co Ltd	China
Huaneng Jingmen Thermal Power Co Ltd	China
Huaneng Jining Canal Power Generation Co Ltd	China
Huaneng Jining High-tech Zone Thermal Power Co Ltd	China
Huaneng Jiuquan Power Generation Co Ltd	China
Huaneng Jiuquan Thermal Power Co Ltd	China
Huaneng Laiwu Power Generation Co Ltd	China
Huaneng Liancheng Power Generation Co	China
Huaneng Linyi Power Generation Co Ltd	China
Huaneng Luoyang Thermal Power Co Ltd	China
Huaneng Luoyuan Power Generation Co Ltd	China
Huaneng Mianchi Thermal Power Co Ltd	China
Huaneng Nanjing Thermal Power Co Ltd	China
Huaneng Ningxia Energy Co Ltd	China
Huaneng Power International INC	China
Huaneng Power International INC	China
Huaneng Qinghai Power Co Ltd	China
Huaneng Shaanxi Power Co Ltd	China
Huaneng Shandong Power Co Ltd	China
Huaneng Shandong Ruyi Coal Power Co Ltd	China
Huaneng Shantou Haimen Power Generation Co Ltd	China
Huaneng (Suzhou Industrial Park) Power Generation Co Ltd	China
Huaneng Suzhou Thermal Power Co Ltd	China
Huaneng Taicang Power Generation Co Ltd	China
Huaneng Weihai Power Generation Co Ltd	China
Huaneng Wuhan Power Generation Co Ltd	China
Huaneng Xindian Power Generation Co Ltd	China
Huaneng Xinjiang Energy Development Co Ltd	China
Huaneng Xinjiang Zhundong Energy Development Co Ltd	China
Huaneng Yimin Coal-Electricity Co Ltd	China
Huaneng Yingcheng Thermal Power Co Ltd	China
Huaneng Yingkou Thermal Power Co Ltd	China
Huaneng Yunnan Diandong Energy Co Ltd	China
Huaneng Zhanhua Thermal Power Co Ltd	China
Huaneng (Zhejiang) Energy Development Co Ltd	China
Huaneng Zuoquan Coal&Power Co Ltd	China
Huanghe Datong Power Co Ltd	China
Huangling Mining Group Co Ltd	China
Huasheng Jiangquan Group	China
Huaxin Energy Aust Pty Ltd	Australia
Huayang Construction Investment Yangquan Thermal Power Co Ltd	China
Huayang Construction Investment Yangquan Thermal Power Co Ltd	China
Huayang Electric Power Co Ltd	China
Huayang New Material Technology Group Co Ltd	China
HuBei Energy Group Co Ltd	China
Hubei Yihua Chemical Industry Co Ltd	China
Hubei Yihua Chemical Industry Co Ltd	China
Hubei Yihua Group Co Ltd	China
Hub Power Co Ltd	Pakistan
Hub Power Holdings Ltd	Pakistan
Hunan Coal Industry Co Ltd	China
Hunan Coal Industry Group Co Ltd	China
Hunan Datang Fuel Development Co Ltd	China
Hunan Huadian Pingjiang Power Generation Co Ltd	China
Hunnu Coal Pty Ltd	Australia
Hunter Valley Energy Coal Pty Ltd	Australia
Hunter Valley Operations (HVO)	Australia
Hunter Valley Operations (HVO)	Australia
Huozhou Coal and Electricity Group Qin'an Coal and Electricity Co Ltd	China
Huozhou Xucun Coal Mine Co Ltd	China
HV Operations Pty Ltd	Australia
Hwange Colliery Co Ltd	Zimbabwe
Hwange Electricity Supply Co Pvt Ltd	Zimbabwe
Hwa Ya Power Corp	Taiwan
H&WB Asia Pacific (Pte Ltd) Corp	Philippines
Ichor Coal NV 	South Africa
IC Ictas Energy Yatirim Holding AS	Turkey
ICVL Zambeze Lda	Mozambique
IDACORP Inc	USA
Idaho Energy Resources Co	USA
Idaho Power Co	USA
Idemitsu Australia Resources Pty Ltd	Australia
Idemitsu Coal Marketing Australia Pty Ltd	Australia
Idemitsu Kosan Co Ltd	Japan
Ikwezi Mining Ltd	South Africa
Ikwezi Mining Pty Ltd	South Africa
IL&FS Energy Development Co Ltd	India
IL&FS Tamil Nadu Power Co Ltd	India
Ilima Coal Co Pty Ltd	South Africa
Imaloto Power Project Co SARL	Madagascar
Imaloto Power Project Ltd	Mauritius
Imbat Madencilik Enerji Turizm San Tic AS	Turkey
Indermani Minerals India Pvt Ltd	India
Indiana Michigan Power Co	USA
Indian Railway Finance Corp Ltd	India
Indian Railways	India
India Power Corp Ltd	India
Indika Capital Investment Pte Ltd	Singapore
Indika Energy Capital III Pte Ltd	Singapore
Indika Energy Capital II Pte Ltd	Singapore
Indika Energy Capital IV Pte Ltd	Singapore
Indika Energy Capital Pte Ltd	Singapore
Indika Energy Trading Pte Ltd	Singapore
Indo Energy Capital II BV	Netherlands
Indo Energy Finance II BV	Netherlands
Industrial Development Corp of South Africa Ltd	South Africa
Inner Mongolia Baoli Coal Co Ltd	China
Inner Mongolia China Coal Mengda New Energy Chemical Co Ltd	China
Inner Mongolia China Coal Yuanxing Energy Chemical Co Ltd	China
Inner Mongolia Daihai Electric Power Co Ltd	China
Inner Mongolia Datang Fuel Co Ltd	China
Inner Mongolia Datang Huayin Xidong Energy Development Co Ltd	China
Inner Mongolia Datang International Tuoketuo Power Generation Co Ltd	China
Inner Mongolia Datang International Xilinhot Mining Industry Co Ltd	China
Inner Mongolia Datang International Zhungeer Mining Co Ltd	China
Inner Mongolia Dian Tou Energy Co Ltd	China
Inner Mongolia Dongyuan Scien Tech Co Ltd	China
Inner Mongolia Energy Generation & Investment Group	China
Inner Mongolia Erdos Investment Holding Group Co Ltd (Erdos Group)	China
Inner Mongolia Halun Energy Co Ltd	China
Inner Mongolia Haoyuan Coal Co Ltd	China
Inner Mongolia Helin Power Generation Co Ltd	China
Inner Mongolia Huaning Thermal Power Co Ltd	China
Inner Mongolia Huineng Coal and Electricity Group Co Ltd	China
Inner Mongolia Huomei Hongjun Aluminum & Power Co Ltd 	China
Inner Mongolia Jilin Guole No.2 Open Pit Coal Mine Co Ltd	China
Inner Mongolia Jimei Mining Industry Co Ltd	China
Inner Mongolia Jingda Power Generation Co Ltd	China
Inner Mongolia Jingda Power Generation Co Ltd	China
Inner Mongolia Jinghai Coal Gangue Power Generation Co Ltd	China
Inner Mongolia Jingke Power Generation Co Ltd	China
Inner Mongolia Jinglong Electric Power Co Ltd	China
Inner Mongolia Jingneng Kangbashi Thermo Power Generation Co Ltd	China
Inner Mongolia Jingneng Shengle Thermo Power Gerneration Co Ltd	China
Inner Mongolia Jingneng Shuangxin Power Generation Co Ltd	China
Inner Mongolia Jingning Thermal Power Co Ltd	China
Inner Mongolia Jingtai Electric Power Generation	China
Inner Mongolia Juda Power Generation Co Ltd	China
Inner Mongolia Manshi Coal Group Co Ltd	China
Inner Mongolia Manshi Investment Group Co Ltd	China
Inner Mongolia Mengda Power Generation Co Ltd	China
Inner Mongolia MengDian HuaNeng Thermal Power Co Ltd	China
Inner Mongolia Mengtai Buliangou Co Ltd	China
Inner Mongolia Mengtai Group Co Ltd	China
Inner Mongolia Ordos Lianhai Coal Industry Co Ltd	China
Inner Mongolia Pingzhuang Coal Group Ltd	China
Inner Mongolia Pingzhuang Energy Co Ltd	China
Inner Mongolia Shangdu No. 2 Power Generation Co Ltd	China
Inner Mongolia Shangdu Power Generation Co Ltd	China
Inner Mongolia Shangdu Power Generation Co Ltd	China
Inner Mongolia Shendong Tianlong Group Co Ltd	China
Inner Mongolia Taiheng Energy Co Ltd	China
Inner Mongolia Tongmei Erdos Mining Investment Co Ltd	China
Inner Mongolia Xilingol Baiyinhua Coal and Power Co Ltd	China
Inner Mongolia Yidong Investment Group Co Ltd	China
Inner Mongolia Yinhong Energy Development Co Ltd	China
Inner Mongolia Yitai Coal Co Ltd	China
Inner Mongolia Yitai Coal Co Ltd	China
Inner Mongolia Yitai Group Co Ltd	China
Inner Mongolia Yuanyuan Energy Group Co Ltd	China
Integrax Bhd 	Malaysia
Integrity Coal Sales Inc	USA
InterGen Energy Holdings (Australia) Pty Ltd	Australia
InterGen NV	Netherlands
Intermountain Power Agency	USA
International Coal Ventures Pvt Ltd	India
International Endesa BV	Netherlands
Inter Rao Credit BV	Russia
Interstate Power and Light Co	USA
Intra Energy Corp Ltd	Australia
Investregionprom LLC	Russia
Iran Power Generation and Transmission Co (TAVANIR)	Iran
Iron Cumberland LLC	USA
Iron Senergy Holding llc	USA
Iskenderun Enerji Uretim ve Ticaret AS	Turkey
Iskenderun Enerji Uretim ve Ticaret AS	Turkey
Israel Electric Corp Ltd	Israel
Italian-Thai Development Public Co Ltd	Thailand
Italian-Thai Hongsa Co Ltd	Thailand
ITC Holdings Corp	USA
ITD Mozambique Limitada	Mozambique
ITD-SQ Joint Venture 	Thailand
ITD-SQ Joint Venture 	Thailand
ITOCHU Coal Resources Australia Pty Ltd 	Australia
ITOCHU Corp	Japan
Itochu Treasury Corp	Japan
Izdemir Enerji Elektrik Uretim AS	Turkey
Izimbiwa Coal Investments Pty Ltd	South Africa
Izimbiwa Coal Pty Ltd	South Africa
Izimbiwa Coal Pty Ltd	South Africa
Jaiprakash Power Ventures Ltd 	India
Jaks Hai Duong Power Co Ltd	Vietnam
Jamshoro Power Co Ltd	Pakistan
Janakuasa Pte Ltd	Singapore
Japan Coal Development Co Ltd	Japan
Jawaharpur Vidyut Utpadan Nigam Ltd	India
JCD Australia Pty Ltd	Australia
JERA Co Inc	Japan
JERA Co Inc	Japan
Jera Global Markets Pte Ltd	Singapore
Jera Global Markets Pte Ltd	Singapore
Jet Power Corp	Philippines
JG Summit Holdings Inc	Philippines
Jhabua Power Ltd	India
Jharkhand Bijli Vitaran Nigam Ltd	India
Jharkhand Central Railway Ltd 	India
Jharkhand Infrapower Ltd	India
Jiangmen Xinhui Shuangshui Third Power Plant Co Ltd	China
Jiangsu Changshu Power Generation Co Ltd 	China
Jiangsu Datang International Lvsigang Power Generation Co Ltd	China
Jiangsu Datang International Rugao Thermal Power Co Ltd	China
Jiangsu Debang Chemical Industry Group Co Ltd	China
Jiangsu Debang Xinghua Chemical Technology Co Ltd	China
Jiangsu Delong Nickel Industry Co	China
Jiangsu Guoxin Binhaigang Power Generation Co Ltd	China
Jiangsu Guoxin Co Ltd	China
Jiangsu Guoxin Investment Group Ltd	China
Jiangsu Guoxin Yangzhou Power Generation LLCO 	China
Jiangsu Huadian Yangzhou Power	China
Jiangsu Huaiyin Power Co Ltd	China
Jiangsu Kanshan Power Co Ltd 	China
Jiangsu Kanshan Power Co Ltd	China
Jiangsu Sheyanggang Power Gen Co Ltd	China
Jiangsu Xinhai Power Co Ltd	China
Jiangxi Datang International Fuzhou Power Generation Co Ltd	China
Jiangxi Datang International Xinyu No. 2 Power Generation Co Ltd	China
Jiangxi Datang International Xinyu Power Generation Co Ltd	China
Jiangxi Ganneng Co Ltd	China
Jiangxi Ganneng Co Ltd	China
Jiangxi Ganneng Co Ltd	China
Jiangxi Province Investment Group Co Ltd	China
Jianli Fenghui Public Resources Investment Management Co Ltd	China
Jiaxing Power Generation Co Ltd	China
Jijian Investment Shouyang Thermal Power Co Ltd	China
Jijian Investment Shouyang Thermal Power Co Ltd	China
Jilin Dongfang Electric Power Co Ltd	China
Jilin Dongfang Power Co Ltd	China
Jilin Provincial Energy Investment Group Co Ltd	China
Jimah East Power Sdn Bhd	Malaysia
Jimah Energy Ventures Sdn Bhd 	Malaysia
Jimah Energy Ventures Sdn Bhd 	Malaysia
Jindal India Thermal Power Ltd 	India
Jindal Mining SA (Pty) Ltd 	South Africa
Jindal Power Ltd	India
Jindal Steel & Power Ltd	India
Jindal Steel & Power (Mauritius) Ltd	South Africa
Jingneng (Chifeng) Energy Development Co Ltd	China
Jingneng Qinhuangdao Thermal Power Co Ltd	China
Jingneng (Xilinguole) Electric Power Co Ltd	China
Jingtai Coal Industry Co Ltd	China
Jingyuan Coal Industry Group	China
Jining Energy Development Group Co Ltd	China
Jining Mining Group Hainer Technology Machatronic Co Ltd	China
Jining Mining Industry Group Co Ltd	China
Jinneng Group Co Ltd	China
Jinneng Holding Coal Group Co Ltd	China
Jinneng Holding Coal Mine Group Dimei Datong Co Ltd	China
Jinneng Holding Coal Mine Group Shuozhou Coal Power Co Ltd	China
Jinneng Holding Coal Mine Group Xuangang Coal Power Co Ltd	China
Jinneng Holding Electric Datang Thermal Power Shanxi Co Ltd	China
Jinneng Holding Electric Puzhou Thermal Power Shanxi Co Ltd	China
Jinneng Holding Electric Shanxi Changzhi Power Generation Co Ltd	China
Jinneng Holding Electric Shanxi Guodian Wangping Power Generation Co Ltd	China
Jinneng Holding Electric Tashan Power Generation Shanxi Co Ltd	China
Jinneng Holding Electric Tongda Thermal Power Shanxi Co Ltd	China
Jinneng Holding Electric Tonghua Shanxi Power Generation Co Ltd	China
Jinneng Holding Electric Tongxing Shanxi Power Generation Co Ltd	China
Jinneng Holding Equipment Manufacturing Group Co Ltd	China
Jinneng Holding Power Group	China
Jinneng Holding Shanxi Coal Industry Co Ltd	China
Jinneng Holding Shanxi Electric Power Co	China
Jinneng Holding Shanxi Electric Power Co	China
Jinyitong SCI.&TECH. Beijing Co Ltd	China
Jinzhou Binhai New Area Jingpeng Thermal Power Co Ltd	China
Jizhong Energy Group Co Ltd	China
Jizhong Energy Resources Co Ltd	China
JMS Mining Pvt Ltd	India
Joban Joint Power Co	Japan
Joban Joint Power Co	Japan
Joban Joint Power Co	Japan
Jointo Energy Investment Co Ltd Hebei	China
JP Elektroprivreda BiH dd (EPBiH)	Bosnia and Herzegovina
J-Power Australia Pty Ltd	Australia
J-POWER (Electric Power Development Co Ltd)	Japan
JRL Coal Inc	USA
JSC Baltic Coal Terminal	Latvia
JSC Chukotenergo	Russia
JSC Donugol 	Russia
JSC Eastern Energy Co	Russia
JSC EuroSibEnergo	Russia
JSC Federal Freight Co 	Russia
JSC HC SDS	Russia
JSC HC SDS-Ugol	Russia
JSC Inter RAO UES - Electric Power Plants	Russia
JSC Kuzbassenergo	Russia
JSC Kuznetskinveststroy	Russia
JSC North Macedonian Power Plants (AD ELEM)	North Macedonia
JSC Omsk RTS	Russia
JSC Razrez Tugnuisky	Russia
JSC SIBECO	Russia
JSC SUEK Group	Russia
JSC SUEK-Krasnoyarsk 	Russia
JSC SUEK-Kuzbass 	Russia
JSC Territorial Generating Co - 11 	Russia
JSC Thermal Power Plants 	Uzbekistan
JSC Tomsk Generation	Russia
JSC Ural Mining Metallurgical Co	Russia
JSC Urgalugol 	Russia
JSC Uzbekenergo	Uzbekistan
JSC Uzbekugol	Uzbekistan
JSPL Mozambique Minerals Lda	Mozambique
JSW Energy Ltd	India
JSW Infrastructure Ltd	India
Jvnan Liyuan Thermal Power Co Ltd	China
Kabra Commercial Ltd	India
Kailuan Energy Chemical Co Ltd 	China
Kailuan Energy Chemical Co Ltd 	China
Kailuan (Group) Ltd Liability Corp	China
Kaisun Holdings Ltd	China (Hong Kong)
Kamarajar Port Ltd	India
Kamisu Power Co Ltd	Japan
Kangal Termik Santral Elektrik Uretim AS	Turkey
Kangaroo Resources Pty Ltd	Australia
Kangra Coal Pty Ltd	South Africa
Kangra Coal Pty Ltd	South Africa
Kansai Electric Power Co Inc	Japan
Kansas City Board of Public Utilities	USA
Kanti Bijlee Utpadan Nigam Ltd	India
Kapar Energy Ventures Sdn Bhd	Malaysia
Kapar Energy Ventures Sdn Bhd	Malaysia
Karaikal Port Pvt Ltd	India
Karakan Invest	Russia
Karam Chand Thapar & Bros Ltd 	India
Karazhyra JSC	Kazakhstan
Karbo-Trade Ltd	Russia
Karnataka Power Corp Ltd	India
Karo Mining Holdings Ltd	Cyprus
Karo Mining Holdings Ltd	Cyprus
Kashima Power Co Ltd	Japan
Kasturi Lal Har Lal Ltd 	India
Kazakhstan Utility Systems LLP	Kazakhstan
Keaton Energy Holdings Ltd	South Africa
Kentucky Power Co	USA
Kentucky Utilities Co	USA
KEPCO Philippines Corp	Philippines
KEPCO SPC Power Corp	Philippines
Khopoli Investments Ltd	Mauritius
Khounmixay Bridge and Road Construction and Repair Co	Laos
Kibo Energy Botswana Pty Ltd	Botswana
Kibo Energy Botswana Pty Ltd	Botswana
Kibo Energy plc	Ireland
Kiewit Mining Group Inc	USA
Kinetic Mines and Energy Ltd 	China (Hong Kong)
Knight Hawk Coal LLC	USA
Kobelco Power Kobe Inc	Japan
Kobelco Power Kobe No. 2 Inc	Japan
Kobe Steel Ltd	Japan
Konya Ilgin Elektrik Uretim AS	Turkey
Konya Seker Sanayi ve Tic AS	Turkey
Kopalnia Wegla Brunatnego Sieniawa Sp z o o	Poland
Korea Coal Corp (KOCOAL)	South Korea
Korea East-West Power Co Ltd	South Korea
Korea Electric Power Corp (KEPCO)	South Korea
Korea Midland Power Co Ltd	South Korea
Korea South-East Power Co Ltd	South Korea
Korea Southern Power Co Ltd	South Korea
Korea Western Power Co Ltd	South Korea
KORES Australia Pty Ltd	Australia
Kosovo Energy Corp J S C	Kosovo
Kraftwerk Mehrum GmbH	Germany
Kraftwerk Schkopau Betriebsgesellschaft GmbH	Germany
Kraftwerk Schkopau GbR	Germany
Kraftwerks und Netzgesellschaft mbH	Germany
KTK Polska Spolka z o o 	Poland
Kukana Enterprises Ltd	Cyprus
Kushiro Coal Mine Co Ltd	Japan
Kushiro Thermal Power Plant Co Ltd	Japan
Kutchh Power Generation Ltd	India
Kuyasa Mining Pty Ltd	South Africa
Kuzbass Power Sales Co PAO	Russia
Kyushu Electric Power Co Inc	Japan
Lafayette Utilities System	USA
Lager Doo	Bosnia and Herzegovina
Lalitpur Power Generation Co Ltd	India
Lalitpur Power Generation Co Ltd	India
Lanco Infratech Ltd	India
Lanka Coal Co Pvt Ltd	Sri Lanka
Lanna Resources Public Co Ltd	Thailand
Lao Holding State Enterprise	Laos
Latrobe Valley Power (Holdings) Pty Ltd	Australia
Lausitz Energie Bergbau AG	Germany
Lausitz Energie Kraftwerke AG	Germany
Lausitz Energie Verwaltungs GmbH	Germany
Leader Energy Pte Ltd	Singapore
LEAG Holding as	Czech Republic
Lemur Holdings Ltd	Mauritius
Lemur Investments Ltd	Mauritius
Lephalale Coal Mines Pty Ltd	South Africa
Levin-Richmond Terminal Corp	USA
LG&E and KU Energy LLC 	USA
Lianyungang Hongyang Thermal Power Co Ltd	China
Liaoning Datang International Huludao Thermal Power Co Ltd	China
Liaoning Datang International Jinzhou Thermal Power Co Ltd	China
Liaoning Datang International Shendong Thermal Power Co Ltd	China
Liaoning Energy Coal Power Industry Co	China
Liaoning Energy Coal Power Industry Co	China
Liaoning Energy Industry Holding Group Co Ltd	China
Liaoning Energy Investment Group Co Ltd	China
Liaoning Tiefa Energy Co Ltd	China
Liaoyang Guocheng Thermal Power Co Ltd	China
Liddell Coal Operations Pty Ltd	Australia
Lignitiki Megalopolis SA	Greece
Lignitiki Μelitis SA	Greece
Limak Energy AS	Turkey
Linzhou Heavy Machinery Group Co Ltd	China
Lipari Energy Inc	USA
Liupanshui Huale Coal Industry Co Ltd	China
Liuzhi Industrial and Mining (Group) Co Ltd	China
Liuzhi Industrial and Mining (Group) Co Ltd	China
LLC Coeclerici Russia 	Russia
LLC Inter RAO Engineering	Russia
LLC Kompaniya VostSibUgol	Russia
LLC Sea Port Sukhodol	Russia
LLC Stevedoring Co Maly port	Russia
LLC SUEK Finance	Russia
LLC Tyvinskaya Gornorudnaya Co	Russia
LLC Ugolny Razrez	Russia
LLC VostokUgol-Dixon	Russia
LLP Ekibastuz GRES-1 named after Bulat Nurzhanov	Kazakhstan
Long Thuan Investment Corp	Vietnam
Longview Power LLC	USA
Louisville Gas & Electric Co	USA
Lower Colorado River Authority	USA
Ltd Liability Co Kuzbassenergo-Finance	Russia
Lu'an Chemical Group Co Ltd	China
Lu'an Xinjiang Coal Chemical (Group) Co Ltd	China
Lubelski Wegiel Bogdanka SA	Poland
Lucky Commodities Pvt Ltd	Pakistan
Lucky Electric Power Co Ltd	Pakistan
Luenmei Quantum Co Ltd	China
Luliang Dongyi Group Coal Gasification Co Ltd	China
Luminant Mining Co LLC	USA
Lurco Coal Eswatini	Eswatini
LX International Corp	South Korea
Lygend Resources & Technology Co Ltd	China
Maamba Collieries Ltd	Zambia
Maatla Energy Ltd	Botswana
Maatla Resources Pty Ltd	Botswana
MACH Energy Australia Pty Ltd	Australia
Madhya Pradesh Power Generating Co Ltd 	India
Magna Resources Corp Pte Ltd	Singapore
Mahanadi Basin Power Ltd 	India
Mahanadi Coalfields Ltd	India
Mahanadi Coal Railway Ltd 	India
Mahanadi Mines and Minerals Pvt Ltd	India
Mahan Energen Ltd	India
Maharashtra State Power Generation Co Ltd 	India
Mahesh Suppliers (India) Pvt Ltd	India
Maheshwari Fuel Chem Pvt Ltd	India
Maheshwari Logistics Ltd	India
Mai Khot Energy Ltd 	Myanmar
Mai Khot Energy Ltd 	Myanmar
Maikuben West Holding JSC	Kazakhstan
Mai-Liao Power Corp (MPC)	Taiwan
Mainova AG	Germany
Maithon Power Ltd 	India
Maithon Power Ltd 	India
Majapahit Finance BV 	Netherlands
Majapahit Holding BV	Netherlands
Major Oak Power LLC	USA
Makole Group Pty Ltd	South Africa
Makomo Resources (Pvt) Ltd	Zimbabwe
Malakoff Corp Bhd	Malaysia
Malakoff Power Bhd	Malaysia
Malakoff Technical Solutions Sdn Bhd	Malaysia
Mangoola Coal Operations Pty Ltd	Australia
Manhattan Resources Ltd	Singapore
Manila Electric Co (MERALCO)	Philippines
Manila Electric Co (MERALCO)	Philippines
Manila Electric Co (MERALCO)	Philippines
Manila Electric Co (MERALCO)	Philippines
Marion County Coal Resources Inc	USA
Mariveles Power Generation Corp 	Philippines
Mariveles Power Generation Corp 	Philippines
Mariveles Power Generation Corp 	Philippines
Mariveles Power Generation Corp 	Philippines
Mariveles Power Generation Corp 	Philippines
Marshall County Coal Resources Inc	USA
Marubeni America Finance Corp	USA
Marubeni Corp	Japan
Marubeni Finance Holland BV 	Netherlands
Marubeni Financial Service Corp	Japan
Marubeni International Finance PLC 	United Kingdom
Marubeni Investment Corp	Cayman Islands
Maruti Clean Coal and Power Ltd	India
Masimong Group Holdings	South Africa
Masinloc Power Partners Co Ltd 	Philippines
MB Power Ltd	India
Mbuyelo Coal Pty Ltd	South Africa
Mbuyelo Coal Pty Ltd	South Africa
Mbuyelo Group Pty Ltd	South Africa
MC Mining Ltd	Australia
MDU Resources Group Inc	USA
Mechel Carbon AG	Switzerland
Mechel Energo OOO	Russia
Mechel Mining AO	Russia
Mechel PAO	Russia
Mega Thermal Coal Corp	Canada
Meijin Energy Group Co Ltd	China
Meja Urja Nigam Private Ltd 	India
Meja Urja Nigam Private Ltd 	India
Menar Holding	Luxembourg
MERALCO PowerGen Corp 	Philippines
MERALCO PowerGen Corp 	Philippines
MERALCO PowerGen Corp 	Philippines
MERALCO PowerGen Corp 	Philippines
Mercator Ltd	India
Merge Mining Holding Ltd 	Indonesia
Metal and Engineering Corp	Ethiopia
Metro Mining Ltd	Australia
Metro Pacific Investments Corp	Philippines
Metro Pacific Investments Corp	Philippines
MGE Energy Inc	USA
Michigan Public Power Agency	USA
MidAmerican Energy Co	USA
MidAmerican Funding LLC	USA
Middlemount Coal Pty Ltd 	Australia
Middlemount Coal Pty Ltd 	Australia
Millmerran Power Management Pty Ltd	Australia
Mina la Margarita SAS	Colombia
Minas de Revuboe Ltda	Mozambique
Mindanao Energy Systems Inc	Philippines
Mine Bilozerska ALC	Ukraine
Minejesa Capital BV	Netherlands
Mine Office Obukhovskaya JSC	Ukraine
Mineralogy Pty Ltd	Australia
Minergy Coal Pty Ltd	Botswana
Minergy Ltd	Botswana
Minergy Power Corp	Philippines
Minergy Power Corp	Philippines
Mini Maritsa iztok EAD (MMI)	Bulgaria
Minminer SA	Colombia
Minnkota Power Cooperative Inc	USA
MIR Trade AG	Switzerland
Mississippi Lignite Mining Co	USA
Mississippi Power Capital Trust II	USA
Mitsubishi Corp Energy Solutions Co Ltd	Japan
Mitsubishi Corp Finance PLC	United Kingdom
Mitsubishi Corp	Japan
Mitsui Matsushima Australia Pty Ltd 	Australia
Mitsui Matsushima Co Ltd	Japan
Mitsui Matsushima Holdings Co Ltd	Japan
Mitsui Matsushima International Pty Ltd	Australia
Mitsui Matsushima Resources Co Ltd	Japan
Mitteldeutsche Braunkohlengesellschaft mbH (MIBRAG)	Germany
Mong Duong Coal JSC	Vietnam
Monongahela Power Co	USA
Monongalia County Coal Resources Inc	USA
Montana-Dakota Utilities Co	USA
Moolarben Coal Mines Pty Ltd	Australia
Moolarben Coal Mines Pty Ltd	Australia
Morella Corp Ltd	Australia
Mormugao Port Trust	India
Morupule Coal Mine Ltd	Botswana
Morupule South Resources Ltd	Botswana
Mountain Coal Co LLC	USA
Mount Pleasant Joint Venture	Australia
Mount Vernon Transfer Terminal LLC	USA
MP Natural Resources Pvt Ltd	India
M Resources Trading Pty Ltd	Australia
Mt Carmel Cogen Inc	USA
Mt Owen Pty Ltd	Australia
Mudanjiang Thermal Power Co Ltd	China
Muhlenberg County Coal Resources Inc	USA
Mukah Energy Minerals Sdn Bhd	Malaysia
Mukah Power Generation Sdn Bhd	Malaysia
Murmansk Bulk Terminal LLC 	Russia
Murmanskiy Morskoi Torgovyi Port JSC 	Russia
Muscatine Power & Water	USA
Muswellbrook Coal Co Ltd	Australia
MVM Matra Energy Ltd	Hungary
MVV RHE AG	Germany
Nabha Power Ltd	India
Nabinagar Power Generating Co Ltd	India
Nacala Corridor Holding Netherlands BV	Netherlands
NACCO Industries Inc	USA
NACG Texas Inc 	USA
Nagata Engineering Co Ltd	Japan
Nakayama Nagoya Joint Power Generation Co Ltd	Japan
Nakoso IGCC Power GK	Japan
Namane Resources Pty Ltd	South Africa
Nam Dinh First Power Holdings Pte Ltd	Singapore
Namibian Ports Authority (Namport)	Namibia
Nan Nan Resources Enterprise Ltd	China (Hong Kong)
Nanshan Group Co Ltd	China
Nareva Holding SA	Morocco
National Aluminium Co Ltd	India
National Development Corp	Tanzania
National Electric Investment Group Xinjiang Energy & Chemical Co Ltd	China
National Energy Group Heze Power Co Ltd 	China
National Energy Group Jiangsu Power Co Ltd	China
National Energy Group Shandong Power Co Ltd	China
National Mineral Development Corp	India
National Power Supply Public Co Ltd	Thailand
Natural Resource Partners LP	USA
Nava Bharat Energy India Ltd 	India
Nava Bharat Ventures Ltd	India
Nava Energy Zambia Ltd 	Zambia
Navajo Transitional Energy Co LLC	USA
Navayuga Power Corp Ltd	India
NC Coal Co Pty Ltd	Australia
NCIG Holdings Pty Ltd	Australia
Ncondezi Coal Co Mozambique Ltda	Mozambique
Ncondezi Energy Ltd	British Virgin Islands
Ncondezi Power Co SA	Mozambique
Ndalama Resources Pty Ltd	South Africa
Nebraska Public Power District	USA
Nectar Coal Handling Mozambique Ltda	Mozambique
New Atlantic International Trading JSC	Vietnam
Newcastle Coal Infrastructure Group Pty Ltd	Australia
New Coal Terminal Beira SA	Mozambique
New Hope Corp Ltd	Australia
New Largo Coal Pty Ltd	South Africa
New Largo Coal Pty Ltd	South Africa
New Largo Coal Pty Ltd	South Africa
New Largo Coal Pty Ltd	South Africa
New Largo Coal Pty Ltd	South Africa
New Largo Coal Pty Ltd	South Africa
New Lenton Coal Pty Ltd	Australia
New Lenton Joint Venture	Australia
Neyveli Uttar Pradesh Power Ltd 	India
Neyveli Uttar Pradesh Power Ltd 	India
Nghi Son 2 Power LLC	Vietnam
Nghi Son 2 Power LLC	Vietnam
Nghi Son 2 Power LLC	Vietnam
Ningbo Energy Group Co Ltd	China
Ningbo Marine Co Ltd	China
Ningbo Marine Co Ltd	China
Ningxia Haosheng Sunshine Energy	China
Ningxia Hongdunzi Coal Industry Co Ltd	China
Ningxia Huadian Yongli Power Co Ltd	China
Ningxia Jingneng Ningdong Electric Power Co Ltd	China
Ningxia Kingho Coal Chemical Group Co Ltd	China
Ningxia Power Collective Asset Investment Group Co Ltd	China
Ningxia Power Investment Corp	China
Ningxia Qinghua Coal & Chemical Group Co Ltd	China
Ningxia Risheng High-tech Industry Co Ltd	China
Ningxia Tianneng Power Co Ltd	China
Ningxia Xinqiao Energy Development Co Ltd	China
Ningxia Younglight Chemicals Co Ltd	China
Ningxia Younglight Coal Industry Co Ltd	China
Ningxia Zhongning Power Generation Co Ltd	China
NISOURCE CAPITAL MARKETS INC	USA
NiSource Finance Corp	USA
NiSource Inc	USA
Nkomati Anthracite Pty Ltd	South Africa
NLC India Ltd	India
NLC Tamil Nadu Power Ltd 	India
Noble Group Holdings Ltd	China (Hong Kong)
Norgener Foreign Investment SA	Chile
North-Eastern Coal Co Ltd 	Russia
Northern Coalfields Ltd 	India
Northern Coal Trading JSC	Vietnam
Northern Indiana Public Service Co LLC	USA
Northern Municipal Power Agency	USA
Northern States Power Co	USA
North Queensland Bulk Ports Corp Ltd	Australia
North Queensland Export Terminal Pty Ltd	Australia
North United Power Co Ltd	China
North Weijiamao Coal Power Co Ltd	China
NorthWestern Corp	USA
North-West Power Generation Co Ltd	Bangladesh
Nova Scotia Power Inc	Canada
NQXT Capital Pty Ltd	Australia
NRG Energy Inc	USA
NRG Energy Services LLC	USA
NRG Gladstone Operating Services Pty Ltd	Australia
NRG Gladstone Operating Services Pty Ltd	Australia
NTPC Ltd	India
NTPC Mining Ltd	India
NTPC-SAIL Power Co Ltd	India
NTPC Tamil Nadu Energy Co Ltd 	India
NuCoal Resources Ltd	Australia
Nui Beo Coal JSC	Vietnam
Oakbridge Pty Ltd	Australia
OCI SE	South Korea
Odas Elektrik Uretim Sanayi Ticaret AS	Turkey
Oddormeanchey Power Industrial Co Ltd	Cambodia
Odelia Coal Trade Pty Ltd	South Africa
Odisha Coal and Power Ltd 	India
Odisha Coal and Power Ltd 	India
Odisha Hydro Power Corp Ltd	India
Odisha Infrapower Ltd	India
Odisha Power Generation Corp Ltd	India
Odisha Power Generation Corp Ltd	India
OGE Energy Corp	USA
Ohio County Coal Resources Inc	USA
Ohio Power Co	USA
Ohio Valley Electric Corp	USA
Ohio Valley Electric Corp	USA
Ohio Valley Electric Corp	USA
Ohio Valley Electric Corp	USA
Ohio Valley Electric Corp	USA
OJSC Coal Company Kuzbassrazrezugol	Russia
OJSC OGK-2	Russia
OJSC Primorskugol	Russia
Okinawa Electric Power Co Inc 	Japan
Oklahoma Gas and Electric Co	USA
Omaha Public Power District	USA
OneEnergy Asia Ltd	China (Hong Kong)
OneEnergy Asia Ltd	China (Hong Kong)
OneEnergy Asia Ltd	China (Hong Kong)
OneEnergy Asia Ltd	China (Hong Kong)
OneEnergy Asia Ltd	China (Hong Kong)
OneEnergy Ventures Ltd	China (Hong Kong)
One Rail Australia Pty Ltd	Australia
Onyx Strategic Investment Management I BV	Netherlands
OOO COTES Engineering 	Russia
OOO Razrez Berezovskiy	Russia
OOO Razrez Mairykhsky	Russia
OOO Razrez Permyakovsky	Russia
OOO SP Barzasskoye tovarischestvo	Russia
Oorja Holdings Pvt Ltd	Singapore
Open-Pit Mine Kiyzassky LLC	Russia
Open-Pit Mine Vostochny LLC	Russia
OPG Power Ventures Plc	India
Oracle Power PLC	United Kingdom
Ordos Chengda Mining Co Ltd	China
Ordos Haohua Fine-Coal Co Ltd	China
Ordos Haohua Guotai Chemical Co Ltd	China
Ordos Haohua Hongqingliang Mining Co Ltd	China
Ordos Wulan Coal (Group) Co Ltd	China
Ordos Yihua Mining Resources LLC	China
Ordos Yinhe Hongtai Coal Power Co Ltd	China
Origin Energy Finance Co Pty Ltd 	Australia
Origin Energy Finance Ltd	Australia
Origin Energy Ltd	Australia
Orion Mining Pty Ltd	Australia
Orissa Integrated Power Ltd	India
OSAKI CoolGen Corp	Japan
OSAKI CoolGen Corp	Japan
Otog Front Banner Changcheng No.3 Mining Co Ltd	China
Otog Front Banner Changcheng No.5 Mining Co Ltd	China
Otog Front Banner Changcheng No.6 Mining Co Ltd	China
Otog Front Banner Great Wall Coal Mine Co Ltd	China
Otog Front Banner Hengyuan Investment Industrial Co Ltd	China
Otter Tail Corp	USA
Otter Tail Power Co	USA
Ouro Negro Energia SA	Brazil
Overlooked Colliery Alpha Pty Ltd	South Africa
OYAK Birlesik Enerji AS	Turkey
Pacific Corp	Vietnam
PacifiCorp Capital II	USA
PacifiCorp Capital I	USA
PacifiCorp Financial Services Inc	USA
PacifiCorp	USA
Pakistan International Bulk Terminal Ltd	Pakistan
PAK KWB Konin	Poland
Palm Concepcion Power Corp	Philippines
Pamodzi Power Ltd	Malawi
Panay Energy Development Corp 	Philippines
Panay Energy Development Corp 	Philippines
Panay Energy Development Corp 	Philippines
Panay Energy Development Corp 	Philippines
Panjiang (Puding) Power Generation Co Ltd	China
PAO Unipro	Russia
Paradip Port Trust	India
Park Elektrik Uretim Madencilik Sanayi ve Ticaret AS	Turkey
Park Joung In	South Korea
Park Teknik Elektrik Madencilik Turizm Sanayi ve Ticaret AS	Turkey
Park Toptan Elektrik Enerjisi Satış Sanayi ve Ticaret AS	Turkey
Patratu Vidyut Utpadan Nigam Ltd 	India
Patratu Vidyut Utpadan Nigam Ltd 	India
Payra Port Authority	Bangladesh
Peabody Energy Australia Coal Pty Ltd	Australia
Peabody Energy Corp	USA
Peabody Securities Finance Corp	USA
Pench Thermal Energy (MP) Ltd	India
Penumbra Coal Mining Pty Ltd	South Africa
Petmin Ltd	South Africa
Petroleum Trading Lao Public Co	Laos
PetroVietnam Power Corp JSC	Vietnam
PGE Elektrownia Opole SA	Poland
PGE Elektrownia Turow SA	Poland
PGE Energia Ciepła Oddział Wybrzeże	Poland
PGE Energia Ciepła SA	Poland
PGE Kopalnia Wegla Brunatnego Belchatow SA	Poland
PGE Kopalnia Węgla Brunatnego Turow SA	Poland
PGE SA (Polska Grupa Energetyczna SA)	Poland
PGE Sweden AB	Sweden
PGE Zespoł Elektrociepłowni Bydgoszcz SA	Poland
PGE Gornictwo i Energetyka Konwencjonalna SA	Poland
PGNIG TERMIKA Energetyka Przemyslowa SA	Poland
PGNiG Termika SA	Poland
Pha Lai Thermal Power JSC	Vietnam
Pha Lai Thermal Power JSC	Vietnam
Phembani Group Pty Ltd	South Africa
Phongsubthavy Group Co Ltd	Laos
Phu Fai Mining Co Ltd	Laos
Phu Fai Mining Co Ltd	Laos
Phu Fai Mining Co Ltd	Laos
Phu Fai Mining Co Ltd	Laos
Phu Fai Mining Co Ltd	Laos
Pine Energy Pte Ltd	Singapore
Pingdingshan Tianan Coal Mining Co Ltd	China
Pingliang Wuju Coal Industry Co Ltd	China
Pinnacle West Capital Corp	USA
PJSC Centrenergo	Ukraine
PJSC Inter RAO	Russia
PJSC Irkutskenergo	Russia
PJSC Kuzbasskaya Toplivnaya Kompaniya	Russia
PJSC Magadanenergo	Russia
PJSC Magadanenergo	Russia
PJSC Priargunsky Industrial Mining and Chemical Union	Russia
PJSC RusHydro	Russia
PJSC Sakhalinenergo	Russia
PKP CARGO CONNECT	Poland
PKP CARGO INTERNATIONAL as	Czech Republic
PKP Cargo SA	Poland
Platinum Alloys Pvt Ltd	India
Platte River Power Authority	USA
PLT Madencilik Sanayi ve Ticaret AS	Turkey
PNOC Exploration Corp	Philippines
Polat Madencilik San ve Tic Ltd Sti	Turkey
Polska Grupa Gornicza	Poland
Polyak Eynez Enerji Uretim Madencilik Sanayi ve Ticaret	Turkey
Polyak Eynez Enerji Uretim Madencilik Sanayi ve Ticaret	Turkey
Port Kembla Coal Terminal Ltd	Australia
Porto do Pecem Geracao de Energia SA	Brazil
Port of Newcastle Ltd	Australia
Port of Newcastle Operations Pty Ltd	Australia
Port Qasim Electric Power Co	Pakistan
Port Waratah Coal Services Ltd (PWCS)	Australia
POSCO Capital Co Ltd	South Korea
Posco Energy Co Ltd	South Korea
Posco Engineering & Construction Co Ltd	South Korea
Posco Holdings Inc	South Korea
Power Assets Holdings Ltd	China (Hong Kong)
PowerChina Gansu Energy Investment Co Ltd	China
PowerChina Resource Ltd	China
Power Construction Corp of China Ltd	China
Power Construction Corp of China / PowerChina	China
Power Finance Corp Ltd	India
Power Generation Corp 1 JSC (EVN Genco 1)	Vietnam
Power Generation Corp 2 JSC (EVN Genco 2)	Vietnam
Power Generation Corp 3 JSC (EVN Genco 3)	Vietnam
PPL Capital Funding Inc	USA
PPL Corp	USA
Prairie Mines & Royalty ULC	Canada
Prairie Power Inc	USA
Prairie State Energy Campus LLC	USA
Prairie State Generating Co LLC	USA
Prakash Industries Ltd	India
Prayagraj Power Generation Co Ltd 	India
Premogovnik Velenje d.d.	Slovenia
Premthai Energy Ltd 	Thailand
Press Metal Aluminium Holdings Bhd	Malaysia
Prisko as	Czech Republic
PROGRESS CAPITAL HOLDINGS INC	USA
Progress Energy Inc	USA
PT ABM Investama Tbk	Indonesia
PT Adani Global	Indonesia
PT Adaro Energy Indonesia Tbk	Indonesia
PT Adaro Energy Indonesia Tbk	Indonesia
PT Adaro Indonesia	Indonesia
PT Adaro Logistics	Indonesia
PT Adaro Power	Indonesia
PT Adimitra Baratama Nusantara 	Indonesia
PT Akbar Indo Makmur Stimec Tbk	Indonesia
PT Alfa Daya Energi	Indonesia
PT Alfa Energi Investama Tbk	Indonesia
PT Alfara Delta Persada	Indonesia
PT Amman Mineral Internasional	Indonesia
PT Amman Mineral Nusa Tenggara	Indonesia
PT Andalan Satria Lestari 	Indonesia
PT Antang Gunung Meratus 	Indonesia
PT Anugrah Karya Raya	Indonesia
PT Anzawara Satria	Indonesia
PT Arkco Global Energi	Indonesia
PT Artha Daya Coalindo	Indonesia
PT Arutmin Indonesia	Indonesia
PT Ascon Indonesia Internasional	Indonesia
PT Astra International Tbk	Indonesia
PT Astrindo Nusantara Infrastruktur Tbk	Indonesia
PT Atlas Resources Tbk	Indonesia
PT Avaneesh Coal Resources	Indonesia
PT Bahari Cakrawala Sebuku	Indonesia
PT Bakrie & Brothers Tbk	Indonesia
PT Bakrie Indo Infrastructure 	Indonesia
PT Bakrie Power	Indonesia
PT Banjarsari Pribumi	Indonesia
PT Banyuasin Power Energy	Indonesia
PT Bara Anugrah Sejahtera	Indonesia
PT Baradinamika Mudasukses	Indonesia
PT Bara Indah Sinergi	Indonesia
PT Baramulti Suksessarana Tbk	Indonesia
PT Baramulti Suksessarana Tbk	Indonesia
PT Baramutiara Prima	Indonesia
PT Bara Utama Persada Raya	Indonesia
PT Barito Pacific Tbk	Indonesia
PT Baruna Dirga Dharma 	Indonesia
PT Batu Bumi Persada	Indonesia
PT Batulicin Nusantara Maritim	Indonesia
PT Bayan Resources Tbk	Indonesia
PT Bayan Resources Tbk	Indonesia
PT Berau Coal Energy Tbk	Indonesia
PT Berkat Bara Jaya	Indonesia
PT Bhakti Energi Persada	Indonesia
PT Bhakti Energi Persada	Indonesia
PT Bharinto Ekatama	Indonesia
PT Bhimasena Power Indo 	Indonesia
PT Bhimasena Power Indo 	Indonesia
PT Bhimasena Power Indo 	Indonesia
PT Bhimasena Power Indo 	Indonesia
PT Bhumi Jati Power	Indonesia
PT Bhumi Jati Power	Indonesia
PT Bhumi Jati Power	Indonesia
PT Bhumi Rantau Energi	Indonesia
PT Bika Global	Indonesia
PT Bintan Aluminum Indonesia	Indonesia
PT Bintan Aluminum Indonesia	Indonesia
PT Bintang Delapan Group	Indonesia
PT BlackGold Energy Indonesia (Indonesia)	Indonesia
PT BlackGold Energy Power (Indonesia)	Indonesia
PT Borneo Coal Trading	Indonesia
PT Borneo Olah Sarana Sukses Tbk 	Indonesia
PT Brayan Bintang Tiga Energi	Indonesia
PT Britmindo	Indonesia
PT Bukit Asam Prima 	Indonesia
PT Bukit Asam Tbk	Indonesia
PT Bukit Enim Energi	Indonesia
PT Bukit Enim Energi	Indonesia
PT Bukit Makmur Mandiri Utama 	Indonesia
PT Bukit Pembangkit Innovative	Indonesia
PT Bukit Pembangkit Innovative	Indonesia
PT Bumi Resources Tbk	Indonesia
PT Central Borneo Energi	Indonesia
PT Central Java Power	Indonesia
PT Cikarang Listrindo Tbk	Indonesia
PT Cipta Kridatama	Indonesia
PT Cirebon Electric Power 	Indonesia
PT Cirebon Electric Power 	Indonesia
PT Cirebon Electric Power 	Indonesia
PT Cirebon Electric Power 	Indonesia
PT Cirebon Electric Power 	Indonesia
PT Cirebon Energi Prasarana 	Indonesia
PT Cirebon Energi Prasarana 	Indonesia
PT Cirebon Energi Prasarana 	Indonesia
PT Cirebon Energi Prasarana 	Indonesia
PT Cirebon Energi Prasarana 	Indonesia
PT Cirebon Energi Prasarana 	Indonesia
PT Cirebon Energi Prasarana 	Indonesia
PT Cirebon Energi Prasarana 	Indonesia
PT Cirebon Power Services	Indonesia
PT Cirebon Power Services	Indonesia
PT Cirebon Power Services	Indonesia
PT Cirebon Power Services	Indonesia
PT Dana Brata Luhur Tbk	Indonesia
PT Darma Henwa Tbk	Indonesia
PT Darma Henwa Tbk	Indonesia
PT Delma Mining Corp	Indonesia
PT Delta Dunia Makmur Tbk	Indonesia
PT Dermaga Perkasapratama 	Indonesia
PT Dian Swastatika Sentosa Tbk	Indonesia
PT Dire Pratama	Indonesia
PT Dire Pratama	Indonesia
PT DSSP Power Sumsel	Indonesia
PT Duta Borneo Mining	Indonesia
PT Duta Buana Mandiri	Indonesia
PT Dwi Guna Laksana Tbk	Indonesia
PT Energitama Bumi Arum 	Indonesia
PT Exploitasi Energi Indonesia Tbk	Indonesia
PT Ganda Alam Makmur	Indonesia
PT Ganda Alam Makmur	Indonesia
PT GH EMM INDONESIA	Indonesia
PT Global Makara Teknik 	Indonesia
PT Golden Eagle Energy Tbk	Indonesia
PT Golden Energy Mines Tbk	Indonesia
PT Golden Energy Mines Tbk	Indonesia
PT Gorontalo Listrik Perdana 	Indonesia
PT Graha Panca Karsa	Indonesia
PT Gunung Bara Utama	Indonesia
PT Guohua Taidian Pembangkitan Jawa Bali	Indonesia
PT Guohua Taidian Pembangkitan Jawa Bali	Indonesia
PT Halmahera Persada Lygend	Indonesia
PT Halmahera Persada Lygend	Indonesia
PT Harita Nickel	Indonesia
PT Harum Energy Tbk	Indonesia
PT Heramba Coal Resources	Indonesia
PT Huadian Bukit Asam Power	Indonesia
PT Imeco Inter Sarana	Indonesia
PT Indika Energy Tbk	Indonesia
PT Indika Inti Corpindo	Indonesia
PT Indominco Mandiri 	Indonesia
PT Indomining	Indonesia
PT Indonesia Asahan Aluminium	Indonesia
PT Indonesia Coal Resources 	Indonesia
PT Indonesia Power	Indonesia
PT Indo Perkasa	Indonesia
PT Indo Perkasa	Indonesia
PT Indo Raya Tenaga	Indonesia
PT Indo Raya Tenaga	Indonesia
PT Indo Raya Tenaga	Indonesia
PT Indo Tambangraya Megah Tbk	Indonesia
PT Insani Baraperkasa	Indonesia
PT Inta Daya Perkasa	Indonesia
PT Internasional Prima Coal	Indonesia
PT Internasional Prima Coal	Indonesia
PT Jambi Prima Coal	Indonesia
PT Jankar Prima	Indonesia
PT Jawa Power	Indonesia
PT Jawa Power	Indonesia
PT Jembayan Muara Bara	Indonesia
PT Jorong Barutama Greston	Indonesia
PT Kalimantan Prima Persada	Indonesia
PT Kaltim Mineral	Indonesia
PT Kaltim Prima Coal 	Indonesia
PT Kaltim Prima Coal 	Indonesia
PT Karbindo Abesyapradhi 	Indonesia
PT Karya Bumi Baratama	Indonesia
PT Karya Manunggal	Indonesia
PT Karya Putra Borneo	Indonesia
PT Karya Putra Borneo	Indonesia
PT Karya Usaha Pertiwi 	Indonesia
PT Kideco Jaya Agung 	Indonesia
PT Kideco Jaya Agung 	Indonesia
PT Kitadin	Indonesia
PT KTC Coal Mining & Energy	Indonesia
PT Lanna Harita Indonesia 	Indonesia
PT Lautan Hutan Lestari	Indonesia
PT Layar Lintas Jaya	Indonesia
PT Lestari Banten Energi 	Indonesia
PT Loa Haur	Indonesia
PT Mabar Elektrindo	Indonesia
PT Mahakam Sumber Jaya 	Indonesia
PT Makmur Sejahtera Wisesa	Indonesia
PT Manambang Muara Enim Co Ltd	Indonesia
PT Manambang Muara Enim Co Ltd	Indonesia
PT Mandiri Intiperkasa	Indonesia
PT Manggala Usaha Manunggal	Indonesia
PT Manoor Bulatn Lestari Indonesia	Indonesia
PT Maritim Sumber Energy	Indonesia
PT Mega Prima Persada	Indonesia
PT Meulaboh Power Generation	Indonesia
PT Minahasa Cahaya Lestari 	Indonesia
PT Mintec Abadi	Indonesia
PT Mitrabahtera Segara Sejati Tbk 	Indonesia
PT Mitrabara Adiperdana Tbk	Indonesia
PT Mitrabara Adiperdana Tbk	Indonesia
PT Mitra Maju Sukses	Indonesia
PT Multi Harapan Utama	Indonesia
PT Multi Tambangjaya Utama 	Indonesia
PT Novem Coal Mining	Indonesia
PT Nusantra Terminal Terpadu	Indonesia
PT Nusa Persada Resources	Indonesia
PT Padangbara Sukses Makmur	Indonesia
PT Paiton Energy	Indonesia
PT Paiton Energy	Indonesia
PT Pamapersada Nusantara	Indonesia
PT Papua Inti Energi 	Indonesia
PT Pelabuhan Buana Reja	Indonesia
PT Pelayaran Bahtera Adhiguna	Indonesia
PT Pelita Samudera Shipping Tbk	Indonesia
PT Pembangkitan Jawa Bali	Indonesia
PT Pembangkitan Perkasa Daya	Indonesia
PT Pembangkitan Perkasa Daya	Indonesia
PT Pendopo Energi Batubara	Indonesia
PT Perkasa Inakakerta 	Indonesia
PT Permata Indah Sinergi	Indonesia
PT Pesona Khatulistiwa Nusantara	Indonesia
PT Petrosea Tbk	Indonesia
PT PJB Investasi	Indonesia
PT PLN Batubara	Indonesia
PT PLN (Persero) (Perusahaan Listrik Negara)	Indonesia
PT PP Energi Tbk	Indonesia
PT PP (Persero) Tbk	Indonesia
PT PP Rusianto Bersaudara	Indonesia
PT Prima Andalan Mandiri Tbk	Indonesia
PT Prima Multi Mineral 	Indonesia
PT Resource Alam Indonesia Tbk	Indonesia
PT Reswara Minergi Hartama	Indonesia
PT Risjadson Development	Indonesia
PT RMK Energy Tbk	Indonesia
PT Samantaka Batubara	Indonesia
PT Samindo Resources Tbk	Indonesia
PT Samindo Utama Kaltim	Indonesia
PT Sea Bridge Shipping	Indonesia
PT Sea Bridge Shipping	Indonesia
PT Senamas Energindo Mineral (SEM)	Indonesia
PT Shenhua Guohua Pembangkitan Jawa Bali	Indonesia
PT Shenhua Guohua Pembangkitan Jawa Bali	Indonesia
PT SIMS Jaya Kaltim	Indonesia
PT Sinar Mas	Indonesia
PT Singlurus Pratama	Indonesia
PT SMR Utama Tbk	Indonesia
PT Sriwijiya Bintang Tiga Energi	Indonesia
PT Sulawesi Mining Investment	Indonesia
PT Sumbagselenergi Sakti Pewali 	Indonesia
PT Sumbagselenergi Sakti Pewali 	Indonesia
PT Sumber Energi Andalan Tbk	Indonesia
PT Sumberenergi Sakti Prima	Indonesia
PT Sumber Global Energy Tbk	Indonesia
PT Sumber Permata Hitam	Indonesia
PT Sumber Segara Prima Daya 	Indonesia
PT Sumber Segara Prima Daya 	Indonesia
PT Sumukha Coal Services	Indonesia
PT Surya Artha Nusantara Finance	Indonesia
PT Tagadaya Minergy	Indonesia
PT Talenta Bumi	Indonesia
PT Tambang Batubara Harum 	Indonesia
PT Tanjung Jati Power Co	Indonesia
PT Tanjung Jati Power Co	Indonesia
PT Tanjung Power Indonesia 	Indonesia
PT Tanjung Power Indonesia 	Indonesia
PT TBS Energi Utama Tbk	Indonesia
PT Tepian Indah Sukses	Indonesia
PT Thailindo Bara Pratama Co Ltd	Indonesia
PT Titan Infra Energy	Indonesia
PT Titan Infra Sejahtera	Indonesia
PT Titan Wijaya	Indonesia
PTT Mining Ltd	China (Hong Kong)
PT Trada Alam Minera Tbk	Indonesia
PT Transcoal Pacific Tbk	Indonesia
PT Trans Power Marine Tbk	Indonesia
PT Trasindo Murni Perkasa	Indonesia
PT Trisensa Mineral Utama	Indonesia
PT Truba Bara Banyu Enim	Indonesia
PT Trubaindo Coal Mining	Indonesia
PT Tuah Turangga Agung	Indonesia
PT Unggul Nusantara	Indonesia
PT United Tractors Tbk	Indonesia
PT Utami Jaya Mulia 	Indonesia
PT Walsin Nickel Industrial Indonesia	Indonesia
PT Wanxiang Steel Indonesia	Indonesia
PT YTL Jawa Timur	Indonesia
Public Power Corp Finance PLC	United Kingdom
Public Power Corp SA	Greece
Public Service Co of Colorado	USA
Public Service Co of Oklahoma	USA
Puckree Group Pty Ltd	South Africa
Punjab State Power Corp Ltd 	India
PWG King & Sons Pty Ltd	Australia
QCoal Pty Ltd	Australia
QCoal Sonoma Pty Ltd	Australia
Qinghua Group Yili Mining Investment Co Ltd	China
Qingyang Xinzhuang Coal Industry Co Ltd	China
Qinhuangdao Port Co Ltd	China
Qinhuangdao Power Co Ltd	China
Qinhuangdao Power Co Ltd	China
Qinhuangdao Qinre Power Generation Co Ltd	China
Qinhuangdao Qinre Power Generation Co Ltd	China
Qinshui Xinhai Energy Co Ltd	China
Quang Ninh Thermal Power JSC 	Vietnam
Quang Ninh Thermal Power JSC 	Vietnam
Quan Jun Da Industrial Co Ltd	China
Queensland Bulk Handling Pty Ltd	Australia
Quezon Management Services Inc	Philippines
Quezon Power (Philippines) Ltd Co 	Philippines
Radiant Coal Benefication Pvt  Ltd 	India
Raichur Power Corp Ltd 	India
Raichur Power Corp Ltd 	India
Raigarh Energy Generation Ltd	India
Rainbow Energy Center LLC	USA
Raipur Energen Ltd	India
Rajasthan Rajya Vidyut Utpadan Nigam Ltd	India
Rajmahal Coal Mining Ltd	India
Ramaco Carbon LLC 	USA
Ramaco Resources Inc	USA
RAMB Sp z o o	Poland
Rapier-Behr Co Ltd	Thailand
RATCH Group Public Co Ltd	Thailand
RATCH Group Public Co Ltd	Thailand
RattanIndia Power Ltd	India
Ravensworth Operations Pty Ltd	Australia
Razrez Arshanovsky LLC	Russia
Razrez Chernogorsky LLC	Russia
Razrez Yuzhny LLC	Russia
RCPL-NORINCO International Power Ltd	Bangladesh
Reading Anthracite Co	USA
REC Ltd	India
Red Hill Mongolia LLC	Mongolia
Refex Industries Ltd	India
Refrigeration Electrical Engineering Corp	Vietnam
Reliance Coal Resources Pvt Ltd	India
Reliance Infrastructure Ltd	India
Reliance Power Ltd	India
Reliance Power Ltd	India
Resurs LLC	Russia
Rey Resources Ltd	Australia
Richards Bay Coal Terminal Pty Ltd	South Africa
Richards Bay Coal Terminal Pty Ltd	South Africa
Rig Tenders Indonesia Tbk	Indonesia
RioEnergy Pvt Ltd	Zimbabwe
RioZim Ltd	Zimbabwe
Rix's Creek Pty Ltd	Australia
R.K.M Powergen Pvt Ltd 	India
Rock Energy International Corp	Philippines
Rolleston Coal Holdings Pty Ltd	Australia
Rongshi International Finance Ltd	China
Rosan Resources Holdings Ltd	China
Rosa Power Supply Co Ltd	India
Rosebud Mining Co	USA
Rosterminalugol JSC	Russia
Royal Group of Companies Ltd	Cambodia
Rudnici Uglja Banovici (RMUB)	Bosnia and Herzegovina
Rudnik i Termoelektrana Gacko	Bosnia and Herzegovina
Rudnik i Termoelektrana Ugljevik	Bosnia and Herzegovina
Rudnik Kovin AD	Serbia
Rudnik uglja AD Pljevlja	Montenegro
Rural Power Co Ltd	Bangladesh
Rusal Capital Designated Activity Co	Ireland
Rushydro Capital Markets DAC	Ireland
Russian Coal JSC	Russia
RWE AG	Germany
RWE Power AG	Germany
RWE Supply & Trading GmbH	Germany
RZM Murowa Holding Pvt Ltd	Zimbabwe
Safi Energy Co SA	Morocco
Safi Energy Co SA	Morocco
Sahakol Equipment Co Ltd	Thailand
Sai Wardha Power Generation Ltd	India
Sakari Resources Ltd	Singapore
Sakata Kyodo Electric Power Co	Japan
Saknakhshiri LLC	Georgia
S Alam Group	Bangladesh
Salt River Project Agricultural Improvement and Power District	USA
Samcheok Blue Power Co Ltd	South Korea
Samcheok Blue Power Co Ltd	South Korea
Samcheok Blue Power Co Ltd	South Korea
Samruk Energy JSC	Kazakhstan
San Buenaventura Power Ltd Co	Philippines
San Buenaventura Power Ltd Co	Philippines
San Buenaventura Power Ltd Co	Philippines
San Buenaventura Power Ltd Co	Philippines
San Buenaventura Power Ltd Co	Philippines
Sanhe Power Gerneration Co Ltd	China
San Miguel Consolidated Power Corp 	Philippines
San Miguel Corp	Philippines
San Miguel Electric Cooperative Inc	USA
San Miguel Energy Corp 	Philippines
San Ramon Power Inc	Philippines
San Ramon Power Inc	Philippines
San Ramon Power Inc	Philippines
San Ramon Power Inc	Philippines
Sany Heavy Equipment International Holdings Co Ltd	China
SAPPHIRE POWER FINANCE LLC	USA
Sarangani Energy Corp	Philippines
Sarangani Energy Corp	Philippines
Sarangani Energy Corp	Philippines
Sarangani Energy Corp	Philippines
Sarawak Energy Resources Sdn Bhd	Malaysia
Sarda Energy & Minerals Hongkong Ltd	China (Hong Kong)
Sarda Energy & Minerals Ltd	India
Sarikaya Karaburun Elektrik Uretim AS	Turkey
Sasan Power Ltd	India
Saskatchewan Power Corp	Canada
Sasol Financing International Ltd	South Africa
Sasol Financing International Ltd/United Kingdom	South Africa
Sasol Financing Pty Ltd	South Africa
Sasol Financing USA LLC	USA
Sasol Ltd	South Africa
Sasol Mining Pty Ltd	South Africa
Saxonvale Coal Pty Ltd	Australia
Scinta South Africa Pty Ltd	South Africa
SC Kuznetskaya Investitsionno – Stroitelnaya Compania (Kisk) 	Russia
SC Sierra Gorda Finance BV	Netherlands
SDEPCI (Shandong Electric Power Engineering Consulting Institute)	China
SDIC Capital Co Ltd	China
SDIC Central China Coal Logistic Co Ltd	China
SDIC Coal Co Ltd	China
SDIC Gansu Electric Power Sales Co Ltd	China
SDIC Hami Energy Development Co	China
SDIC Meizhouwan Port Co Ltd	China
SDIC Panjiang Power Generation Co Ltd	China
SDIC Power Holding Co Ltd	China
SDIC Power Holding Co Ltd	China
Sedgman Pty Ltd	Australia
Sejingkat Power Corporation Sdn Bhd	Malaysia
Sembcorp Energy India Ltd	India
Sembcorp Financial Services Pte Ltd	Singapore
Sembcorp Industries Ltd	Singapore
SEM-Calaca Power Corp	Philippines
Semirara Mining and Power Corp	Philippines
Sengwa Colliery Pvt Ltd 	Zimbabwe
Sengwa Colliery Pvt Ltd 	Zimbabwe
Sengwa Power Station Pvt Ltd	Zimbabwe
SEPCO III Electric Power Construction Corp	China
SEPCO Virgin Ltd	British Virgin Islands
SEPC Power Pvt Ltd	India
Serbian Oil Co	Serbia
Seriti Coal Pty Ltd	South Africa
Seriti Coal Pty Ltd	South Africa
Seriti Coal Pty Ltd	South Africa
Seriti Coal Pty Ltd	South Africa
Seriti Coal Pty Ltd	South Africa
Seriti Power	South Africa
Seriti Power	South Africa
Seriti Power	South Africa
Seriti Power	South Africa
Seriti Power	South Africa
Seriti Resources Holdings Pty Ltd	South Africa
Seriti Resources Holdings Pty Ltd	South Africa
Seriti Resources Holdings Pty Ltd	South Africa
Seriti Resources Holdings Pty Ltd	South Africa
Seriti Resources Holdings Pty Ltd	South Africa
Sev.en Commodities AG	Lichtenstein
Sev.en EC as	Czech Republic
Sev.en Energy Group	Czech Republic
Severni Energeticka as	Czech Republic
Severoceske doly AS	Czech Republic
Severomuysky Tunnel-2 LLC	Russia
Shaanxi Binchang Mining Group Co Ltd	China
Shaanxi Coal and Chemical Industry Group Co Ltd	China
Shaanxi Coal Chemical Group Fugu Energy Investment Co Ltd	China
Shaanxi Coal Chenghe Mining Co Ltd	China
Shaanxi Coal Industry Co Ltd	China
Shaanxi Coal Power Lueyang Co Ltd	China
Shaanxi Energy Investment Co Ltd	China
Shaanxi Energy Zhaoshipan Coal & Elec Co Ltd 	China
Shaanxi Energy Zhaoshipan Coal Power Co Ltd	China
Shaanxi Investment Group Co Ltd	China
Shaanxi Qingshuichuan Energy Co Ltd	China
Shaanxi Qinlong Electric Power Co Ltd	China
Shaanxi Shangluo Power Co Ltd	China
Shaanxi Shanmei Hancheng Mining Industry Co Ltd	China
Shaanxi Tongchuan Mining Co Ltd	China
Shaanxi Yanchang Petroleum and Balasu Coal Industry Co Ltd	China
Shaanxi Yanchang Petroleum (Group) Co Ltd	China
Shaanxi Yanchang Petroleum Jingbian Coal Industry Co Ltd	China
Shaanxi Yanchang Petroleum Yulin Kekegai Coal Industry Co Ltd	China
Shaanxi Yihua Mining Development Co Ltd	China
Shaanxi Yuansheng Coal Co Ltd	China
Shaanxi Yulin Energy Group Co Ltd	China
Shaanxi Yulin Energy Group Guo Jia Tan Coal Mine Co Ltd	China
Shaanxi Yulin Energy Group Hengshan Coal Power Co Ltd	China
Shaanxi Yuneng Yushen Southwest Thermal Power Co Ltd	China
Shaanxi Zhongneng Coalfield Co Ltd	China
Shaanxi Zhuyuan Jiayuan Mining Co Ltd	China
Shakhta Sadkinskaya LLC	Russia
Shakhta Sadkinskaya-Severnaya LLC 	Russia
Shakhta Sadkinskaya-Vostochnaya LLC	Russia
Shakhta Sibirskaya LLC	Russia
Shakhta Ugolnaya JSC	Russia
Shandong Energy Group Co Ltd	China
Shandong Energy Guizhou Mining Co Ltd	China
Shandong Energy Inner Mongolia Shenglu Energy& Chemical Co Ltd	China
Shandong Energy Linyi Mining Group Co Ltd	China
Shandong Energy Longkou Mining Group Co Ltd	China
Shandong Energy Xinwen Mining Group Co Ltd	China
Shandong Energy Zaozhuang Mining Group Co Ltd	China
Shandong Energy Zibo Mining Group Co Ltd	China
Shandong Hua Ju Energy Co Ltd (Hua Ju Energy)	China
Shandong Hua Ju Energy Co Ltd (Hua Ju Energy)	China
Shandong Huaneng Liaocheng Thermal Power Co Ltd	China
Shandong Lutai Holding Group Co Ltd	China
Shandong Luxi Power Generation Co Ltd	China
Shandong Public Group Co Ltd	China
Shandong Tagao Mining Equipment Manufacturing Co Ltd 	China
Shandong Tagao Mining Equipment Manufacturing Co Ltd 	China
Shandong Weishan Lake Mining Group Ltd	China
Shandong Yili Electric Industry Co Ltd	China
Shandong Yulong Petrochemical Co Ltd	China
Shandong Yulong Petrochemical Co Ltd	China
Shandong Zhonghua Power Co Ltd 	China
Shandong Zhonghua Power Co Ltd 	China
Shanduka Coal Pty Ltd	South Africa
Shangcheng Power Co	China
Shanghai Datun Energy Resources Co Ltd	China
Shanghai Electric Group Corp	China
Shanghai Electric Power Co Ltd	China
Shanghai Electric Power Co Ltd	China
Shanshan County Taixin Kunde Coal Co Ltd	China
Shantou Huadian Power Generation Co Ltd	China
Shanxi Coal Import & Export Group Co Ltd	China
Shanxi Coal International Energy Group Co Ltd	China
Shanxi Coal Transportation and Sale Group Dongda Energy Co Ltd	China
Shanxi Coal Transportation and Sales Group	China
Shanxi Coal Transportation and Sales Group Xingong Coal Industry Co Ltd	China
Shanxi Coking Coal Energy Group CoLtd	China
Shanxi Coking Coal Group Co Ltd	China
Shanxi Coking Coal Igood Equipment Remanufacturing shares Co Ltd	China
Shanxi Datang International Linfen Thermal Power Co Ltd	China
Shanxi Datang International Shentou Power Generation Co Ltd	China
Shanxi Datang International Yungang Thermal Power Co Ltd	China
Shanxi Dragon Power Generation Co Ltd 	China
Shanxi Fenxi Mining (Group) Co Ltd	China
Shanxi Fenxi Ruitai Zhengfeng Coal Industry Co	China
Shanxi Fenxi Zhenghui Coal Industry Co	China
Shanxi Fenxi Zhengxin Coking Coal Co Ltd	China
Shanxi Fenxi Zhongtai Coal Industry Co Ltd	China
Shanxi Gaohe Energy Co Ltd	China
Shanxi Gaohe Energy Co Ltd	China
Shanxi Guojin Power Co Ltd	China
Shanxi Hexin Power Development Co Ltd	China
Shanxi Hong An Xiang Technology Develo[ment Co Ltd	China
Shanxi Huairen Lianshun Xida Chaigou Coal Industry Co Ltd	China
Shanxi Huayang Group New Energy Co Ltd	China
Shanxi International Electricity Group Ltd Co	China
Shanxi International Energy Group	China
Shanxi Jingneng Lvlin Electric Power Co Ltd	China
Shanxi Jingyu Electric Power Co Ltd	China
Shanxi Jinmei Qinxiulong Bay Energy Co Ltd	China
Shanxi Jinmei Taigang Energy Co Ltd	China
Shanxi Lanhua Coal Industry Group Co Ltd	China
Shanxi Lanhua Sci-Tech Venture Co Ltd	China
Shanxi Lanhua Sci-Tech Venture Co Ltd	China
Shanxi Linfen Thermal Power Co Ltd	China
Shanxi Linxian Jinyuan Coal Co Ltd	China
Shanxi Lu'An Environmental Energy Development Co Ltd	China
Shanxi Lu'an Group Xingguang Coal Power Co Ltd	China
Shanxi Lu'an Mining Industry (Group) Co Ltd	China
Shanxi Luxin Energysources Group	China
Shanxi Maohua Energy Investment Co Ltd	China
Shanxi Pingshu Coal Industry Co Ltd	China
Shanxi Province JINSHEN Energy Co Ltd	China
Shanxi Province JINSHEN Energy Co Ltd	China
Shanxi Shigang Coal Industry Company	China
Shanxi Shuozhou Pinglu District Maohua Bailu Coal Industry Co Ltd	China
Shanxi Shuozhou Pinglu District Maohua Dongyi Coal Industry Co Ltd	China
Shanxi Shuozhou Pinglu District Maohua Wantongyuan Coal Industry Co Ltd	China
Shanxi Shuozhou Pinglu District Maohua Xialiyuan Coal Industry Co Ltd	China
Shanxi Shuozhou Shanyin Youyi Coal Industry Co Ltd	China
Shanxi Xinzhou Shenda Energy Group Co Ltd	China
Shanxi Zhangshan Power Generation Co 	China
Shaoguan Pingshi Power Plant Co Ltd	China
Shenergy Co Ltd	China
Shenergy (Group) Co Ltd	China
Shenghai Coal Industry Co Ltd	China
Shenghua & Elion Energy Co Ltd	China
Shenhua Australia Holdings Pty Ltd	Australia
Shenhua Coal Transportation & Sales Co Ltd	China
Shenhua (Fujian) Energy Co Ltd	China
Shenhua International (Hong Kong) Ltd 	China (Hong Kong)
Shenhua Shendong Power Shanxi Hequ Power Generation Co Ltd	China
Shenhua Watermark Coal Pty Ltd	Australia
Shenhua Xinjie Energy Co Ltd 	China
Shenmu Ciyaota Mining Co Ltd	China
Shenmu Hongliulin Mining Co Ltd	China
Shenmu Shengfu Mining Co Ltd	China
Shenmu Shenxin Thermal Power Co Ltd	China
Shenyang Huarun Thermal Power Co Ltd	China
Shenyang Huitian Thermal Power Co Ltd	China
Shenyang Jinshan Energy Co Ltd	China
Shenyang Tian An Technology Co Ltd 	China
Shenzhen Energy Group Co Ltd	China
Shenzhen Energy Hopewell Power (Heyuan) Co Ltd	China
Shijiazhuang Dongfang Thermal Power Group Co Ltd	China
Shikoku Electric Power Co Inc	Japan
Shine Energy Pty Ltd	Australia
Shivee Ovoo JSC	Mongolia
Shreesatya Mines Pvt Ltd	India
Shubarkol Komir JSC	Kazakhstan
Shumba Energy Ltd	Mauritius
Shunan Power Corp	Japan
Shunan Power Corp	Japan
SIA Ogles un Kokss	Latvia
Sibanthracite Group	Russia
Sibanthracite Kuzbass	Russia
Sibanthracite Logistic LLC	Russia
Sibanthracite Overseas AG	Switzerland
Sibanthracite Overseas Pte Ltd	Singapore
Siberian Anthracite JSC	Russia
Siberian Generation Co	Russia
Sibuglemet Group LLC	Russia
Sichuan Coal Group Da Zhu Co	China
Sichuan Coal Group Panmei Co	China
Sichuan Coal Industry Group LLC	China
Sichuan Furong Group Industrial Co Ltd	China
Sichuan Guang'an Power Generation Co Ltd	China
Sichuan Hongda (Group) Co Ltd	China
Sichuan Qiya Aluminium Industry Group	China
Siddiqsons Energy Ltd 	Pakistan
Siddiqsons Ltd (Siddiqsons Group)	Pakistan
Sierra Coal Pty Ltd	Australia
Sierra Pacific Power Co	USA
Signal Peak Energy LLC	USA
Signal Peak Energy LLC	USA
Sihanoukville Special Economic Zone Co	Cambodia
Silopi Elektrik Uretim AS 	Turkey
Silver Elephant Mining Corp	Canada
Silver Unicorn Coal and Mineral Resources Pty Ltd	South Africa
Sindh Carbon Energy Ltd	Pakistan
Sindh Engro Coal Mining Co 	Pakistan
Sindh Engro Coal Mining Co 	Pakistan
Sindh Engro Coal Mining Co 	Pakistan
Sing Heng Seng Co Ltd 	Thailand
Sinohydro Corporation (PowerChina International Group Ltd)	China
Sinopec Century Bright Capital Investment Ltd	China (Hong Kong)
Sinopec Great Wall Energy & Chemical Co Ltd	China
Sinopec Group Overseas Development Ltd	British Virgin Islands
Sino Sindh Resources Pvt Ltd (SSRL)	China
Sisonke Coal Processing (Pty) Ltd	South Africa
SJVN Ltd	India
SJVN Thermal Pvt Ltd	India
Skoda Praha AS	Czech Republic
SK Samanta & Co Pvt Ltd	India
SKS Power Generation (Chhattisgarh) Ltd	India
SKW Biuro Projektowo-Techniczne Sp z o o	Poland
SMC Consolidated Power Corp 	Philippines
SMC Global Power Holdings Corp	Philippines
Societatea Complexul Energetic Hunedoara SA	Romania
Sojitz Blue Pty Ltd	Australia
Sojitz Development Pty Ltd	Australia
Sokolovska Uhelna AS	Czech Republic
Solntsevsky Coal Mine LLC	Russia
Soma Kyodo Power Co Ltd	Japan
Soma Kyodo Power Co Ltd	Japan
Soma Kyodo Power Co Ltd	Japan
Soma Termik Santral Elektrik Uretim AS	Turkey
Song Hau 2 Power Co Ltd	Vietnam
Sonoma Mine Management Pty Ltd	Australia
Source California Energy Services Inc	USA
South African Coal Mining Holdings Ltd 	South Africa
South Carolina Public Service Authority	USA
South Eastern Coalfields Ltd	India
Southern Coal Co LLC	Russia
Southern Co Capital Funding Inc	USA
Southern Co Capital Trust III	USA
Southern Co Capital Trust II	USA
Southern Co Capital Trust I	USA
Southern Co Capital Trust IV	USA
Southern Co Capital Trust VI	USA
Southern Co Capital Trust V	USA
Southern Co Gas Capital Corp	USA
Southern Illinois Power Cooperative	USA
Southern Indiana Gas and Electric Co	USA
Southern Kuzbass Coal Co PJSC	Russia
Southern Kuzbass Power Plant PAO	Russia
SouthGobi Resources Ltd	Canada
South Luzon Thermal Energy Corp 	Philippines
Southwestern Electric Power Co	USA
Southwestern Public Service Capital I	USA
Southwestern Public Service Co	USA
Southwest Luzon Power Generation Corp	Philippines
SPC Power Corp	Philippines
SPC Power Corp	Philippines
SPIC 2016 US Dollar Bond Co Ltd	China
SPIC Chongqing Hechuan Power Generation Co	China
SPIC Guizhou Jinyuan Group Co	China
SPIC Hebei Power Electric Power Co Ltd	China
SPIC Henan Electric Power Co Ltd	China
SPIC Jiangxi Electric Power Co Ltd	China
SPIC Jilin Electric Power Co Ltd	China
SPIC Jilin Electric Power Co Ltd	China
SPIC Mengdong Energy Group	China
SPIC MTN Co Ltd	China
SPIC Ningxia Energy Aluminum Co Ltd	China
SPIC Northeast Electric Power Co Ltd	China
SPIC Shanxi Aluminum Co Ltd	China
SPIC Yuanda Environmental Protection Co Ltd	China
Springboklaagte Mining Pty Ltd 	South Africa
Springsure Mining Pty Ltd	Australia
Square Butte Electric Cooperative Inc	USA
SS Power-II Ltd	Bangladesh
SS Power-I Ltd	Bangladesh
Stanmore Resources Ltd	Australia
Stanwell Corp Ltd	Australia
State Development and Investment Corp (SDIC)	China
State Grid Anhui Electric Power Co Ltd	China
State Grid Chongqing Electric Power Co	China
State Grid Corp of China (SGCC)	China
State Grid East Inner Mongolia Power Co	China
State Grid Fujian Electric Power Co	China
State Grid Gansu Electric Power Co	China
State Grid Henan Electric Power Co	China
State Grid Jiangsu Electric Power Co	China
State Grid Overseas Investment (2013)Ltd	China (Hong Kong)
State Grid Overseas Investment (2014) Ltd	China (Hong Kong)
State Grid Overseas Investment (2016) Ltd	China (Hong Kong)
State Grid Overseas Investment Ltd	China (Hong Kong)
State Grid Shandong Electric Power Co	China
State Grid Shanxi Electric Power Co	China
State Grid Sichuan Electric Power Co	China
State Grid Xinjiang Electric Power Co	China
State Grid Zhejiang Electric Power Co	China
State Power Investment Corp (SPIC)	China
STEAG GmbH	Germany
STEAG State Power Inc	Philippines
ST International Co Ltd	South Korea
Stratatech Mineral Resources Pvt Ltd	India
SUEK AG	Switzerland
SUEK-Khakassia LLC	Russia
SUEK Polska Sp z o o	Poland
Sultan Energy Phils Corp	Philippines
Sumisho Coal Australia Pty Ltd	Australia
Sumitomo Corp Capital Europe PLC 	United Kingdom
Sumitomo Corp Capital Netherlands BV	Netherlands
Sumitomo Corp	Japan
Sumitomo Joint Electric Power Co Ltd	Japan
Summit Onahama S Power Corp	Japan
Summit Southern Cross Power Holdings Pty Ltd	Australia
Sundiro Holding Co Ltd	China
Sunflag Iron & Steel Co Ltd	India
Sunflower Electric Power Corp Inc	USA
Sunrise Coal LLC	USA
Sunset Power International Pty Ltd (Delta Electricity)	Australia
SWEPCO Capital I	USA
SWEPCo Capital Trust I	USA
Taekwang Power Holdings Co Ltd	South Korea
TAIAN FAMUR COAL MINING EQUIPMENT SERVICES	China
Taiheiyo Kouhatsu Inc	Japan
Taijin Mining Investment Co Ltd	China
Taiwan Power Co (TAIPOWER)	Taiwan
Taiyuan China Resources Coal Co Ltd	China
Taiyuan Coal Gasification Group Corp Ltd	China
Taiyuan Heating Power Co	China
Taiyuan Mine Mechanical and Electrical Co Ltd 	China
Talcher Fertilizers Ltd	India
Talcher Fertilizers Ltd	India
Taldinskaya Mining Company	Russia
Talen Energy Corp	USA
TALTEK Group of Companies	Russia
Talwandi Sabo Power Ltd	India
Tameh Holding sp Z oo	Poland
Tamil Nadu Generation and Distribution Corp Ltd 	India
Tancoal Energy Ltd	Tanzania
Tancoal Energy Ltd	Tanzania
Tangshan Caofeidian Coal Port Co Ltd	China
Tanjung Bin Energy Sdn Bhd	Malaysia
Tanjung Bin Power Sdn Bhd	Malaysia
Tanzania China International Mineral Resources Ltd	Tanzania
Tanzania China International Mineral Resources Ltd	Tanzania
TAQA Morocco SA	Morocco
TAQA Neyveli Power Co Pvt Ltd	India
Tata Power Co Ltd	India
Tauron Cieplo Sp	Poland
TAURON Polska Energia SA	Poland
Tauron Wydobycie SA	Poland
Tauron Wytwarzanie SA	Poland
Tavistock Collieries (Pty) Ltd	South Africa
TBEA (Tebian Electric Apparatus) Co Ltd	China
TC Carbon	Russia
TCC Energy Co Ltd 	Thailand
Team Energy Corp 	Philippines
Team Energy Corp 	Philippines
TECO FINANCE INC	USA
Tejo Energia SA	Portugal
Telangana State Power Generation Corp 	India
Tenaga Nasional Bhd (TNB)	Malaysia
Tendele Coal Mining Pty Ltd	South Africa
Tennessee Valley Authority	USA
Tenughat Vidyut Nigam Ltd	India
Teplaren Kosice as (TEKO)	Slovakia
Teplarna Otrokovice as	Czech Republic
Terminal de Carvão da Matola	Mozambique
Termoelektrarna Sostanj doo	Slovenia
Termotasajero SAESP	Colombia
TerraCom Ltd	Australia
Terrene Minerals Trading Private Ltd	India
Territorial Generation Co No 14 PJSC	Russia
Texhong Textile Group Ltd	China (Hong Kong)
Texhong Vietnam Industrial Park Ltd	Vietnam
Thai Capital Corp Public Co Ltd	Thailand
Thailand Anthracite Co Ltd	Thailand
Thai Mozambique Logistica SA	Mozambique
Thai Mozambique Logistica SA	Mozambique
Thai Mozambique Logistica SA	Mozambique
ThalNova Power Thar Pvt Ltd	Pakistan
Thang Long Power Plant JSC 	Vietnam
Thar Coal Block-1 Power Generation Co Pvt Ltd	Pakistan
Thar Electricity Pvt Ltd	Pakistan
Thar Energy Ltd	Pakistan
Tharisa PLC	Cyprus
THDC India Ltd	India
The AES Corp	USA
The Andhra Pradesh Mineral Development Corp Ltd 	India
Thebe Investment Corp	South Africa
The Coteau Properties Co	USA
The Falkirk Mining Co	USA
The National Coal Supply Corporation Ltd (NCSC)	Israel
The North American Coal Corp	USA
Therma Visayas Inc 	Philippines
Therma Visayas Inc 	Philippines
The Sabine Mining Co	USA
The Singareni Collieries Co Ltd 	India
The Southern Co	USA
The Tomatoh Coal Center Co Inc	Japan
Thiess Pty Ltd	Australia
Thuan Hai Corp	Vietnam
Thunder Basin Coal Co LLC	USA
Thungela Resources Ltd	South Africa
Tiandi Science & Technology Co Ltd	China
Tianjin Datang International Panshan Power Generation Co Ltd	China
Tianjin Junliangcheng Power Generation Co Ltd	China
Tianjin SDIC Jinneng Electric Power Co Ltd	China
Tiger Energy Trading Pte Ltd 	Singapore
Tigers Realm Coal Ltd	Australia
Titan Mining and Energy Corp 	Philippines
TNB Fuel Services Sdn Bhd	Malaysia
TNB Global Ventures Capital Bhd	Malaysia
TNB Janamanjung Sdn Bhd	Malaysia
TNB Manjung Five Sdn Bhd	Malaysia
TNB Power Generation Sdn Bhd	Malaysia
TNB Western Energy Bhd	Malaysia
Tobata Cooperative Thermal Power Co Inc	Japan
Tohoku Electric Power Co Inc	Japan
Tokyo Century Corp	Japan
Tokyo Electric Power Co Inc	Japan
Toledo Power Co	Philippines
Toledo Power Co	Philippines
Toledo Power Co	Philippines
Toledo Power Co	Philippines
Tongmei Datang Tashan Coal Mine Co Ltd	China
Top Energy Co Ltd Shanxi	China
Top Frontier Investment Holdings Inc	Philippines
Toyo Ventures Holdings Bhd	Malaysia
TPI Polene Power Public Co Ltd	Thailand
TPP Maritsa East 2 EAD	Bulgaria
Transalloys Pty Ltd	South Africa
TransAlta Corp	Canada
TransAlta Generation Ltd	Canada
TransAlta Holdings US Inc	USA
TransAlta OCP LP	Canada
TransNamib Holdings Ltd	Namibia
Transnet SOC Ltd	South Africa
Trans-Ugol LLC	Belarus
Trapper Mining Inc	USA
Trapper Mining Inc	USA
Trapper Mining Inc	USA
Tri-State Generation and Transmission Association Inc	USA
TRN Energy Pvt Ltd	India
TSBP Sekong Power and Mineral Co Ltd	Laos
Tsetsens Mining and Energy LLC	Mongolia
Tucson Electric Power Co	USA
Tun Thwin Mining Co Ltd	Myanmar
Turkish Coal Enterprises	Turkey
Turkiye Taskomuru Kurumu	Turkey
Twenty First Century Mining Pvt Ltd	India
UC RUSAL PLC	Russia
U&D Mining Industry (Australia) Pty Ltd	Australia
Udupi Power Corp Ltd 	India
Ugleprominvest Group	Russia
Ugleprominvest LLC	Russia
Ulan Coal Mines Ltd	Australia
Umcebo Mining Pty Ltd	South Africa
Umcebo Mining Pty Ltd	South Africa
Unicorn Capital Partners Ltd	South Africa
Union Electric Co	USA
Uniper Kraftwerke GmbH	Germany
Uniper SE	Germany
Uniper UK Ltd	United Kingdom
Unique Mining Services Public Co Ltd	Thailand
United Bulk Shipping Pte Ltd	Singapore
United Bulk Shipping Pte Ltd	Singapore
Universal Coal Development VIl Pty Ltd	South Africa
Universal Coal Development VIl Pty Ltd	South Africa
Universal Coal PLC	United Kingdom
UNS Energy Corp	USA
Uroica Precision Information Engineering Co Ltd 	China
Urumqi Xinweixin Import and Export Trade	China
Usibelli Coal Mine Inc	USA
Ust-Kamenogorsk CHPP LLP	Kazakhstan
Uthaka Energy Pty Ltd	South Africa
Uttar Pradesh Rajya Vidyut Utpadan Nigam Ltd	India
Vale Mocambique SA	Mozambique
Valeria Coal Holdings Pty Ltd	Australia
Vang Danh Coal JSC	Vietnam
Van Phong Power Co Ltd	Vietnam
Vaskiluodon Voima Oy	Finland
Vectren Capital Corp	USA
Vectren Corp	USA
Vedanta Finance (Jersey) Ltd	Jersey
Vedanta Finance UK Ltd 	United Kingdom
Vedanta Ltd	India
Vedanta Resources Finance Ltd	United Kingdom
Vedanta Resources Ltd	United Kingdom
Veolia Energia Lodz	Poland
Veolia Energia Poznan	Poland
Veolia Polska SA	Poland
Vidarbha Industries Power Ltd	India
Vietnam Electricity Group (EVN)	Vietnam
Vietnam National Coal Mineral Industries Holding Corp Ltd (Vinacomin)	Vietnam
Vietnam Oil and Gas Group (PetroVietnam)	Vietnam
Vinh Tan 3 Energy JSC	Vietnam
Vinh Tan 3 Energy JSC	Vietnam
Vinh Tan 3 Energy JSC	Vietnam
Vinh Tan 3 Energy JSC	Vietnam
Vistra Corp	USA
Vistra Finance Corp	USA
Vivant Corp	Philippines
Vivant Energy Corp	Philippines
Vivant Integrated Generation Corp	Philippines
Vizag General Cargo Berth Pvt Ltd	India
Vostochny Port JSC	Russia
VPR Mining Infrastructure Pvt Ltd	India
Vrsanska uhelna as	Czech Republic
Vung Ang II Thermal Power Co Ltd	Vietnam
Vung Ang II Thermal Power Co Ltd	Vietnam
Vung Ang II Thermal Power Co Ltd	Vietnam
Vung Ang II Thermal Power Co Ltd	Vietnam
Vung Ang II Thermal Power Co Ltd	Vietnam
Wabash Valley Power Association Inc	USA
Wambo Coal Pty Ltd	Australia
Wambo Coal Pty Ltd	Australia
Wandoan Holdings Pty Ltd	Australia
Wanhua Chemical Group Co Ltd	China
Wanhua Chemical (Ningbo) Thermal Power Co Ltd	China
Wanhua Chemical (YANTAI) CHLOR-ALKALI Thermal POWER Co Ltd	China
Wanji Holding Group Co Ltd	China
Waratah Coal Pty Ltd	Australia
Washington H Soul Pattinson and Co Ltd	Australia
WEC Energy Group Inc	USA
Węglokoks Energia	Poland
Węglokoks Kraj Sp z o o	Poland
Węglokoks SA	Poland
Weiqiao Textile Co Ltd	China
WE Power LLC	USA
Wescoal Holdings Ltd	South Africa
Wescoal Mining Pty Ltd	South Africa
Wescoal Trading Pty Ltd	South Africa
West Bengal Mineral Development & Trading Corp Ltd	India
West Bengal Power Development Corp Ltd	India
Western Coal and Energy Co	Zimbabwe
Western Coalfields Ltd 	India
Western Farmers Electric Cooperative	USA
Western Fuels Association Inc	USA
Western Fuels Wyoming Inc	USA
Westmoreland Absaloka Mining LLC	USA
Westmoreland Beulah Mining LLC	USA
Westmoreland Mining Holdings LLC	USA
Westmoreland Mining LLC	USA
Westmoreland Rosebud Mining LLC	USA
Westmoreland San Juan Mining LLC	USA
Westmoreland Savage Mining LLC	USA
Westshore Terminals Investment Corp	Canada
Westshore Terminals LP	Canada
Wheeling Power Co	USA
Whitehaven Coal Ltd	Australia
Wiggins Island Coal Export Terminal Pty Ltd	Australia
Wilpinjong Coal Pty Ltd	Australia
Wintime Energy Co Ltd	China
Wintime Holding Group Ltd	China
Wisconsin Electric Power Co	USA
Wisconsin Power and Light Co	USA
Wisconsin Public Service Corp	USA
Wison Engineering Services Co Ltd	China
WMC Finance (USA) Ltd	Australia
Wollongong Coal Ltd 	Australia
Wolverine Fuels LLC	USA
Wuhan Boiler Co Ltd	China
Wushenqi Mengda Mining Co Ltd	China
Wuxiang Xishan Power Generation Co Ltd	China
Wyodak Resources Development Corp	USA
Wyong Coal Pty Ltd	Australia
XCEL Energy Inc	USA
Xcoal Energy & Resources LLC	USA
Xekong Thermal Power Plant Co Ltd	Laos
Xiamen Huaxia Power International Development Co Ltd	China
Xiang Mei lida Mine Equipment Co Ltd 	China
Xiangyuan Hexin Power Co Ltd	China
Xilingol Fengfeng Energy Co Ltd	China
Xinfa Group Co Ltd	China
Xinjiang Beishan Mining Co Ltd	China
Xinjiang Chuxing Energy Co Ltd	China
Xinjiang Energy (Group) Co Ltd	China
Xinjiang Energy (Group) Hetian Energy Co Ltd	China
Xinjiang Guotai Xinhua Wucaiwan Mining Industry Co Ltd	China
Xinjiang Guoxin Coal Energy Co Ltd	China
Xinjiang Huadian Changji Thermal Power Co Ltd	China
Xinjiang Huadian Xiheishan Power Generation Co Ltd	China
Xinjiang Huadian Xiheishan Power Generation Co Ltd	China
Xinjiang Jiangna Mining Industry Co Ltd	China
Xinjiang Jinlong Power Group Co Ltd	China
Xinjiang Jinlong Shenwu Energy Development Co Ltd	China
Xinjiang Lu'an Energy Chemistry Co	China
Xinjiang Lu'an Xiexin Zhundong Energy Co Ltd	China
Xinjiang Luntai County Yuxin Industry and Trade Co Ltd	China
Xinjiang Production and Construction Corps Hongxing Power Generation Co Ltd	China
Xinjiang Qiya Energy Aluminum Electric Co Ltd	China
Xinjiang Ruihong Coal and Electricity Co Ltd	China
Xinjiang Ruihong Power Gen Co	China
Xinjiang Shengwo Energy Development Co Ltd	China
Xinjiang Shenxin Development Co Ltd	China
Xinjiang Sixth Agricultural Division Coal Power Co Ltd	China
Xinjiang Tianchi Energy Sources Co Ltd	China
Xinjiang Tianfu Energy Co Ltd	China
Xinjiang Tianfu Group Co Ltd	China
"Xinjiang Tianlong Hope Energy Co Ltd
Xinjiang Tianmeng Huize Coal Development Co Ltd	China
Xinjiang Tianshan Power Co Ltd	China
Xinjiang Tianshan Power Qitai Energy Co Ltd	China
Xinjiang Tianye Co Ltd	China
Xinjiang Tianye Group Co Ltd	China
Xinjiang Turpan Xingliang Mining Co Ltd	China
Xinjiang Xingmei Mining Company	China
Xinjiang Zhenxing Tianyuan Coal Industry Co Ltd	China
Xinjiang Zhongfu Mining Co Ltd	China
Xinjiang Zhongtai Chemical Co Ltd	China
Xishan Coal Electricity Group Co Ltd	China
Xukuang Group Xinjiang Sai'er Energy Co Ltd	China
Xuzhou Mining Group Co Ltd	China
Yan'an Checun Coal Industry (Group) Co Ltd	China
Yan'an Energy Chemical (Group) Co Ltd	China
Yancheng Power Generation Co Ltd	China
Yancoal Australia Ltd	Australia
Yancoal Australia Ltd	Australia
Yancoal International (Holding) Co Ltd	China (Hong Kong)
Yancoal International (Holding) Co Ltd	China (Hong Kong)
Yancoal Resources Ltd	Australia
Yangmei Chemical Co Ltd	China
Yangmei Chemical Co Ltd	China
Yangquan Coal Industry Group Boli Coal Mine Co Ltd	China
Yangquan Coal Industry Group Qiyuan Coal Industry Co Ltd	China
Yangquan Coal Industry Group Yicheng Shanghe Coal Industry Co Ltd	China
Yankuang Energy Group Co Ltd	China
Yankuang Energy Group Co Ltd	China
Yankuang Group (Cayman) Ltd	Cayman Islands
Yanmei Heze Energy & Chemistry Co	China
Yanmei Heze Energy & Chemistry Co	China
Yanmei Wanfu Energy Co Ltd	China
Yanmei Wanfu Energy Co Ltd	China
Yanzhou Coal Industry Ordos Energy Chemical Co Ltd	China
Yanzhou Coal Industry Ordos Energy Chemical Co Ltd	China
Yanzhou Coal Industry Shanxi Energy Chemical Co Ltd	China
Yanzhou Coal Industry Shanxi Energy Chemical Co Ltd	China
Yanzhou Coal Industry Yulin Energy Chemical Co Ltd	China
Yanzhou Coal Industry Yulin Energy Chemical Co Ltd	China
Yaojie Coal & Electricity Tianzhu Coal Industry Co Ltd	China
Yaojie Coal Power Co Ltd	China
Yaojie Coal Power Group Jiuquan Tianbao Coal Industry Co Ltd	China
Yarrabee Coal Co Pty Ltd	Australia
Yarrabee Coal Co Pty Ltd	Australia
Yatagan Termik Enerji Uretim AS	Turkey
Yazdani International Pvt Ltd	India
Yazdani Steel & Power Ltd	India
YCRT (Yacimientos Carbon Río Turbio)	Argentina
Yel Enerji Elektrik Uretim Sanayi Ticaret AS	Turkey
Yenidere Termik Enerji Elektrik Uretim ve Maden Sanayi AS	Turkey
Yenikoy Kemerkoy Elektrik Uretim ve Ticaret AS	Turkey
Yenikoy Kemerkoy Elektrik Uretim ve Ticaret AS	Turkey
Yenisei Territorial Generating Co (TGC-13)	Russia
Yildirim Enerji Holding AS	Turkey
Yildirim Holding AS	Turkey
Yili Qinghua Energy Development Co	China
Yilmaden Holding AS	Turkey
YILYAK Yakit Pazarlama Ticaret AS	Turkey
Yima Coal Industry Group Co Ltd	China
Yiyuan County Yuanneng Heating Power Co Ltd	China
Yiyuan County Yuanneng Thermal Power Co Ltd	China
Yongcheng Coal and Electricity Holding Group Co Ltd	China
Yonggui Energy Development Company Jiaozishan Branch  	China
YS Madencilik Sanayi Ticaret Ltd Sti	Turkey
YTL Corp Bhd	Malaysia
YTL Corp Finance (Labuan) Ltd	Malaysia
YTL Power International Bhd	Malaysia
YTL Utilities Finance 2 Ltd	Cayman Islands
YTL Utilities Finance 3 Ltd	Cayman Islands
YTL Utilities Finance 4 Ltd	Cayman Islands
YTL Utilities Finance 6 Ltd	Cayman Islands
YTL Utilities Finance Ltd	Cayman Islands
Yuanbaoshan Power Generation Co Ltd	China
Yulin Shenhua Energy Co Ltd	China
Yulin Shenshupan Mining Investment Co Ltd	China
Yunnan Coal Chemical Industry Group Co Ltd	China
Yunnan Dongyuan Coal Industry Group Co Ltd	China
Yunnan Dongyuan Coal&Power Co Ltd	China
Yunnan Guoneng Enterprise Management Co Ltd	China
Yunnan Investment Holdings Group Co Ltd	China
Yunnan Power Investment Co Ltd	China
Yunnan Province Energy Investment Group Co Ltd	China
Yunnan Xiaolongtan Mining Bureau Co Ltd	China
Yutian Chunyu Thermal Power Co Ltd	China
Zambezi Gas Zimbabwe Pvt Ltd	Zimbabwe
ZAO Stroyservis	Russia
ZE PAK SA Group (Zespoł Elektrowni Patnow Adamow Konin SA)	Poland
Zesa Holdings Pvt Ltd	Zimbabwe
Zespół Elektrowni Dolna Odra SA	Poland
ZEW Kogeneracja SA	Poland
Zhalai Nuoer Coal Industry Co Ltd	China
Zhanjiang Power Co Ltd	China
Zhejiang Electric Power Construction Co Ltd	China
Zhejiang Hugeleaf Co Ltd	China
Zhejiang Provincial Energy Group Co Ltd	China
Zhejiang Zheneng Electric Power Co Ltd	China
Zhejiang Zhenhai Power Gen Co	China
Zhenfeng County Power Investment	China
Zhengming Coal Industry Co Ltd	China
Zhengzhou Coal Industry & Electric Power Co Ltd	China
Zhengzhou Coal Industry Group Co Ltd	China
Zhengzhou Coal Mining Machinery Group Co Ltd 	China
Zhengzhou Zhongrui Industrial Group Co Ltd	China
Zhonglian Runshi Xinjiang Coal Industry Co	China
Zhongmei Hami Power Generation Co Ltd	China
Zhongmei Heilongjiang Coal Chemical (Group) Co Ltd	China
Zhongtian Hechuang Energy Co Ltd	China
Zhongtian Hechuang Energy Co Ltd	China
Zhongtian Hechuang Energy Co Ltd	China
Zhongyu Guoxin Investment Co Ltd	China
Zhongzheng International Co Ltd	China (Hong Kong)
Zhungeer Banner Baishupo Coal Co Ltd	China
Zimbabwe Power Co Pvt Ltd	Zimbabwe
Zimbabwe ZhongXin Electric Energy	Zimbabwe
Zungu Investments Co Pty Ltd	South Africa
Zvolenska Teplarenska as	Slovakia
